do n't underestimate my power . 	不要 小看 我 的 力量 。 
could you please talk a bit louder ? i ca n't hear very well . 	你 能 大声 点 讲 吗 ？ 我 听 不 太清 。 
now is the time to act . 	现在 是 行动 的 时候 了 。 
i was just talking about tom . 	我 仅仅 是 在 和 Tom 交谈 。 
you have n't changed at all . 	你 真的 一点 没变 。 
this is a beautiful flower . 	这是 一朵 美丽 的 花 。 
how much do you want in terms of salary ? 	您 想要 多少 工资 ？ 
she 's got a good eye for paintings . 	她 对 绘画 有 很 好 的 鉴赏力 。 
everyone comes to tom for advice . 	每个 人 都 请 教汤姆 。 
one of the girls was left behind . 	这些 女孩 当中 其中 一个 被 留下 来 了 。 
i got it free . 	我 是 免费 得到 的 。 
i do n't believe the child came to tokyo alone . 	我 不 相信 孩子 能 独自 到 东京 。 
there is n't anyone in the room . 	房间里 没有 任何人 。 
i will have finished reading this novel by the time you come tomorrow . 	你 明天 来 的 时候 ， 我 就 看 完 这本 小说 了 。 
i like may the best of all the months . 	所有 月份 中 我 最 喜欢 五月 。 
that 's a pencil . 	那 是 一支 铅笔 。 
i caused him a lot of trouble . 	我给 他 带 来 了 很多 麻烦 。 
he has no chance of succee@@ ding . 	他 没 有 成功 的 机会 。 
he would often come to see us when i was a child . 	当我 还是 个 孩子 时 ， 他 经常来 看望 我们 。 
the teacher gave us homework . 	老师 给 我们 布置 了 家庭 作业 。 
she put on socks . 	她 穿 上 袜子 。 
i 've got to go to the bank . 	我 必须 到 银行 去 。 
i told you not to talk about the matter in her presence . 	我 跟 你 说 过 她 在 的 时候 不要 说 这件 事 。 
i spoke to tom last night . 	昨晚 我 和 汤姆 说话 了 。 
i ca n't understand how tom could know . 	我 不 懂 汤姆 怎么 知道 的 。 
he is the rich@@ est man on earth . 	他 是 世界 上 最 有 钱 的 人 。 
tom sure talks a lot . 	汤姆 一定 很能 讲 。 
let them learn from us . 	让 他们 向 我们 学习 。 
do you know how to cook meat ? 	你 知道 怎么 煮 肉 吗 ? 
you do n't like gambling , do you ? 	你 不 喜欢 赌博 ， 是 吗 ？ 
it 's just what i wanted . 	我 想要 的 就是 这个 。 
what i hate most of all is having to reci@@ te tex@@ ts from memory . 	我 最 讨厌 背诵 课文 了 。 
i 'm here to as@@ sist you . 	我来 协助 你 。 
all of the milk was spilled . 	所有 的 牛奶 都洒 出去 了 。 
he likes anything sweet . 	他 喜欢 一切 甜 的 东西 。 
what is it that tom wants to eat ? 	汤姆 想 吃 的 是 什么 ？ 
what do you like to do in your free time ? 	你 空闲 时间 喜欢 做 什么 ？ 
what we had to do was really quite simple . 	我们 要 做 的 很 简单 。 
if it is fine tomorrow , we 'll go on a picnic . 	如果 明天 天气 好 ， 我们 就 去 野餐 。 
a truck was standing in the middle of the road . 	路 中间 有 一辆 卡车 。 
a fire broke out after the earthquake . 	地震 之后发生 了 火灾 。 
tom plans to return . 	汤姆 打算 回来 。 
i would like to re@@ tract my pre@@ vious sta@@ te@@ ment . 	我 想 撤回 我 之前 的 陈述 。 
i prefer apples to oranges . 	比起 橘子 ， 我 更 喜欢 苹果 。 
tom told me that he does n't like car@@ b@@ on@@ ated drinks . 	汤姆 告诉 我 他 不 喜欢 碳酸 饮料 。 
tri@@ m the fat off the meat . 	切除 这块 肉 的 脂肪 。 
can i use my medical insurance ? 	我 可以 使用 我 的 医疗 保险 吗 ？ 
do you drink a lot of milk ? 	你 喝 很多 牛奶 吗 ？ 
of course . 	当然 。 
i got up early yesterday . 	昨天 我 很早 起床 。 
i met her on a certain winter day . 	冬天 的 某日 ， 遇到 了 她 。 
he does n't know english at all . 	他 一点 也 不 懂 英语 。 
this is a very interesting book . 	这是 一本 非常 有趣 的 书 。 
have you seen my glasses anywhere ? 	你 曾 在 哪里 看到 过我 的 眼镜 吗 ？ 
i just do n't want to lose you . 	我 只是 不想 失去 你 。 
did tom send you ? 	汤姆 派出 了 你 们 吗 ？ 
the goods were tran@@ spor@@ ted by ship . 	这批 货物 是 由 船 只 运送 的 。 
what 's the name of this tune ? 	这歌 叫 什么 名字 ？ 
you 've gained weight , have n't you ? 	你 的 体重 增加 了 ， 不是 吗 ？ 
he was kind enough to take me to the hospital . 	他 好心 地 把 我 送到 医院 。 
he is afraid of snakes . 	他 怕 蛇 。 
mary is n't really sick . she 's only pretending to be sick . 	玛丽 不是 真病 。 她 只是 装病 。 
why do n't you talk to him ? 	你 为 甚么 不 跟 他讲 ？ 
we had a rest in the sha@@ de . 	我们 在 树荫下 休息 。 
what were you doing in the at@@ tic ? 	你 在 阁楼 上 做 了 什么 ？ 
please re@@ consider . 	请 重新 考虑 一下 。 
we want to know the facts . 	我们 想 知道 真相 。 
she was asked to convince him to get his son or someone else to paint the house . 	她 被 要求 去 说服 他 以 让 他 或者 他 的 儿子 或者 是 别的 人来 粉刷 屋子 。 
you ca n't say no . 	你 无法 说 “ 不 ” 。 
when does the game begin ? 	游戏 几点 开始 ？ 
i arrived at n@@ ari@@ ta airport this morning . 	我 今天 早上 抵达 了 成田 机场 。 
work slowly . 	干活 慢点 。 
school begins at 8@@ :30 a@@ .m . 	学校 8 点半 开始 上课 。 
tom had to go himself . 	汤姆 不得不 自己 去 。 
i called tom up . 	我 打 电话给 汤姆 了 。 
give me something to eat . 	给我点 东西 吃 。 
this is a picture of my sister . 	这是 我 姊 姊 的 照片 。 
she saw herself in the mirror . 	她 看到 镜子里 的 自己 。 
she left her son a lot of money . 	她 留 了 很多 钱 给 她 儿子 。 
i 'd like seats on the first floor . 	我 想要 一楼 的 座位 。 
a cat came out from under the desk . 	一 只 猫从桌 底下 出来 。 
he calls her up every night . 	他 每天 晚上 打电话给 她 。 
turn off the light . 	关灯 。 
do i have to go to the party ? 	我 需要 去 派 对 吗 ？ 
the old man walked across the road carefully . 	老人 小心翼翼 地过 了 马路 。 
it 's none of your business . 	这不关 你 的 事 。 
do you think tom is weal@@ thy ? 	你 认为 汤姆有 钱 吗 ？ 
do n't be afraid to make a mistake . 	别 害怕 犯错 。 
i 'd rather you stayed at home . 	我宁愿 你 待 在家 里 。 
we had a mi@@ ld winter last year . 	去年 冬天 很 暖和 。 
is there an ap@@ p for that ? 	有 它 的 应用 吗 ？ 
where is the book ? 	那 本书 在 哪儿 ？ 
what time does bo@@ ar@@ ding begin ? 	什么 时候 开始 登机 ？ 
read as much as possible . 	尽 可能 地多 阅读 书籍 。 
he is afraid of the dog . 	他 怕 那 只 狗 。 
can you see ? 	你 能 看 吗 ？ 
will you all be here tomorrow ? 	明天 你 一整天 都 会 在 这里 吗 ? 
she had her hand@@ bag stolen . 	她 的 手提包 被 偷 了 。 
who else u@@ ses this room ? 	还有 谁 用 这个 房间 ？ 
a bridge was built across the river . 	人们 修 了 一座 桥过 河 。 
you look happy today . 	你 今天 看起 来 很 高兴 。 
i really need to read all this . 	我 真的 需要 把 这 都 读 了 。 
tom fell off his bicycle . 	汤姆 从 他 的 自行车 上 掉 了 下来 。 
we all have secrets . 	我们 都 有 秘密 。 
who does the cooking in your home ? 	你 家里 谁 做饭 ？ 
stop foo@@ ling around . 	不要 随便 开 玩笑 。 
it 's a new book . 	那本书 是 一本 新书 。 
the information is very important to us . 	这些 信息 对 我们 非常 重要 。 
he is a doctor by profession . 	他 的 职业 是 医生 。 
all of a sudden , it began raining . 	突然 开始 下雨 。 
what subject do you like best ? 	你 最 喜欢 哪 一个 科目 ? 
tom drank my apple juice . 	Tom 喝 我 的 苹 果汁 。 
you ought to get to work on time . 	你 应该 准时 上班 。 
english is just one of over 2@@ ,@@ 7@@ 00 languages in the world today . 	今天 ， 英语 只是 世界 上 超过 2 , 700 种语 言 的 其中 之一 。 
people of all ages like this song . 	这 首歌 老少 皆 宜 。 
english is spoken in america . 	在 美国 说 英语 。 
the post office is down the street . 	邮局 在 街 那头 。 
do n't worry about it . 	不要 担心 它 。 
she has lost weight . 	她 的 体重 减轻 了 。 
water is liquid . when it freezes , it becomes so@@ lid . 	水是 液体 。 冻 起来 就 成 了 固体 。 
the roses in the garden are bloo@@ ming . 	在 花园里 的 玫瑰 正盛 开著 。 
the report is u@@ tterly false . 	这份 报告 完全 错误 。 
the end does not always justi@@ fy the means . 	为 了 正当 目的 并非 总是 可以 不择 手段 . 
some boys came into the classroom . 	有些 男孩 走进 了 教室 。 
it 's a pity when somebody dies . 	有人 死 了 的 时候 真是 遗憾 。 
you had better get away from here at once . 	你 最好 立刻 离开 这里 。 
i admire your courage . 	我 佩服 你 的 勇气 。 
tom gave mary a nice present . 	汤姆给 了 玛丽 一个 不错 的 礼物 。 
do you still want to talk to me ? 	你 还 想 跟 我 谈 吗 ？ 
we are traveling on a tight bu@@ dget . 	我们 很 节省 地 旅行 。 
was this wall built to keep people out or to keep them in ? 	建造 这 堵墙 是 为了 把 人 隔 在 外面 还是 把 他们 留在 里面 ？ 
it was very nice seeing you again . 	非常 高兴 再次 见 到 你 。 
please do n't ask . 	请 不要 问 。 
i do n't believe such things exist . 	我 不 相信 这样 的 事情 存在 。 
what else have you figured out ? 	你 还 发现 什么 了 ？ 
he has a wife and two young children to provide for . 	他 有 一个 妻子 和 两个 孩子 要 养活 。 
finally , he achie@@ ved his goal . 	他 终于 达到 了 自己 的 目标 。 
i do n't want to hurt his feelings . 	我并 不想 伤害 他 的 感情 。 
i got your fa@@ x the other day . 	我前 几天 收到 了 你 的 传真 。 
she gave me a strange look . 	她 奇怪 地 看 了 我 一眼 。 
you 're working too hard . take it easy for a while . 	你 工作 太 勤奋 了 。 休息 一会 吧 。 
i lent him a cd . 	我 借给 他 一盘 CD 。 
how about going out for a walk ? 	出去 散步 怎么样 ？ 
tom did n't waste any time , did he ? 	汤姆 不浪费 一点 时间 ， 不是 么 ？ 
god knows we did everything we could . 	上帝 知道 我们 做 了 我们 所能 做 的 事 。 
you should tell him the truth . 	你 该 告诉 他 真相 。 
ber@@ n is the capital of switzerland . 	伯恩是 瑞士 首都 。 
good evening . 	晚上 好 ！ 
i agree with him . 	我 同意 他 。 
i 'm sure i can find something for you to do . 	我 确定 我 能 找 点给 你 做 的 事 。 
this is not very sty@@ lish . 	这 不是 很 流行 。 
i 'll be free all day tomorrow . 	明天 我 一整天 都 有空 。 
please put on your shoes . 	请 穿 上 你 的 鞋子 。 
can i drive the tra@@ ctor ? 	我能 开 拖拉 机 吗 ？ 
why should i thank tom ? 	我为 甚么 该 感谢 汤姆 ？ 
you deserve the prize . 	你 应该 得到 这个 奖金 。 
he lives alone . 	他 一个 人 生活 。 
i got acquainted with him in france . 	我 在 法国 认识 了 他 。 
being sick is very boring . 	生病 很无聊 。 
tom did n't know what he 'd say to mary . 	汤姆 不 知道 他 要 对玛丽 说 甚么 。 
he placed the ladder against the fence . 	他 把 梯子 倚 著栅栏 放 。 
may i have a talk with you ? 	我能 和 你 谈谈 吗 ？ 
if i had the money , i would immediately buy this computer . 	我 要是 有钱 ， 立马 就 买 这台 电脑 。 
she is qua@@ li@@ fied as a nurse . 	她 是 个 合格 的 护士 。 
his house was small and old . 	他 的 房子 又 小 又 旧 。 
i 'm so stupid . 	我 真蠢 。 
they called in a doctor because the child was ill . 	他们 打 电话给 医生 因为 这个 孩子 生病 了 。 
you must do it . 	你 必须 去 做 。 
patience is sometimes the most effe@@ ctive weap@@ on . 	耐心 有时候 是 最 有效 的 武器 。 
your suggesti@@ on seems reasonable . 	你 的 建议 似乎 是 合理 的 。 
he told me he would go to ven@@ ice . 	他 告诉 过 我 他 会 去 威尼斯 。 
tom said he has n't decided what needs to be done . 	汤姆 说 他 还没 决定 要 做 甚么 。 
there is n't any so@@ a@@ p . 	没有 任何 肥皂 。 
i do n't think he 'll come . 	我 不 认为 他 会 来 的 。 
do n't be afraid to make mistakes when speaking english . 	说 英语 的 时候 不要 怕 犯错 。 
this is secret between you and me . 	这是 我们 之间 的 秘密 。 
people grow more cy@@ ni@@ cal with age . 	人会 随著 年龄 的 增长 而 更加 地 玩世不恭 。 
you 're our only hope . 	你 是 我们 唯一 的 希望 。 
what size shoes do you wear ? 	你 穿 几号 的 鞋子 ? 
i will badly miss you if you leave japan . 	如果 你 离开 日本 ， 我会 非常 想 你 的 。 
please turn off the television . 	请 把 电视关 掉 。 
i returned the knife which i had borrowed . 	我 把 我 借来 的 刀 还 了 。 
he is old enough to drive a car . 	他 的 年纪 可以 开车 了 。 
she has changed grea@@ tly since i last saw her . 	她 和 以前 比起 来变 了 很多 
may i see your bo@@ ar@@ ding pass , please ? 	请 让 我 看看 您 的 登机证 好 吗 ? 
tom is looking for a new job . 	汤姆 在 找 新 工作 。 
for the teacher , teaching her was fun . 	对 教师 来 说 ， 教 她 很 有趣 。 
these are cakes that she ba@@ ked herself . 	这些 是 她 自己 烤 的 蛋糕 。 
i 've already put tom to work on it . 	我 已经 让 汤姆 去 做 它 了 。 
i think you know that 's not true . 	我 认为 你 知道 那 不是 真的 。 
i 'm leaving for canada tomorrow . 	我 明天 要离 开去 加拿大 。 
let 's go as soon as it stops raining . 	只要 雨 一停 我们 就 走 。 
i wo n't talk to him anymore . 	我 不会 再 跟 他 说 话 了 。 
she was tired , but she kept working . 	她 累 了 ， 但 她 继续 工作 。 
tell tom that i do n't need his help . 	告诉 汤姆 我 不 需要 他 的 帮助 ！ 
i had a telephone call from her . 	我 有 一通 来 自 她 的 电话 。 
it is two miles from here to the park . 	从 这里 到 公园 距离 两 英里 。 
he ran faster than his brother did . 	他 跑 得 比 他 哥哥 快 。 
that boy used to drop in on me . 	那 男孩儿 来访 过 我家 。 
we played soccer yesterday . 	我们 昨天 踢 了 足球 。 
i 'm opposed to any type of war . 	我 反 对 任何 形式 的 战争 。 
who did you talk to ? 	你 和 谁 说话 呢 ？ 
i received an invitation . 	我 收到 了 一张 请帖 。 
tom is kind to everybody . 	汤姆 对 每个 人 都 好 。 
he is a good fel@@ low . 	他 是 个 好人 。 
he came to japan two years ago . 	他 两 年前 来 日本 。 
tom has to do that right away . 	汤姆 必须 马上 去 做 。 
tom would accept . 	汤姆会 接受 。 
which hat is yours ? 	哪顶 帽子 是 你 的 ？ 
this is uncle tom 's farm . 	这是 汤姆 叔叔 的 农场 。 
i 'm glad that i did n't buy something like this . 	我 很 高兴 没有 买 这样 的 东西 。 
do you know how the accident happened ? 	你 知道 这个 意外 是 如何 发生 的 吗 ？ 
tom drinks juice . 	Tom 喝 果汁 。 
there is a for@@ k missing . 	少 一把 叉子 。 
it 's clear that there 's a rather strong disa@@ gree@@ ment between the two . 	很明显 的 是 这两者 之间 有 很 强烈 的 分歧 。 
they wash their hands . 	他们 洗手 。 
years passed . 	多少 年 过去 了 。 
do you like any of these pictures ? 	你 喜欢 这些 画里 的 任何 一幅 吗 ? 
even though i studied english for 6 years in school , i 'm not good at speaking it . 	尽管 我 在 学校 学了 6 年 英语 ， 我 还是 说 不好 。 
tom is no longer a member of this club . 	汤姆 不再 是 俱乐部 的 成员 了 。 
the old church by the lake is very beautiful . 	河边 的 老 教堂 很 漂亮 。 
tom would n't hurt anyone . 	汤姆不会 伤害 任何人 。 
my vision is getting worse these days . 	这些 天 我 的 视力 正在 变差 。 
i wo n't work overtime today . 	今天 我 不 加班 。 
i 'll go with you as far as the bridge . 	我会 跟着 你 走 到 桥 那里 。 
we are going downtown to eat pizza . 	我们 要 去 市中心 吃 比萨 。 
i passed the city hall on my way to the station . 	我 去 车站 的 路上 路过 了 市政 厅 。 
i feel sad every now and then . 	我 不时 地觉 得 难过 。 
let 's not waste time arguing about it . 	我们 别 再 浪费 时间 争论 了 。 
this is a stupid de@@ sign . 	这份 设计 很蠢 。 
prices are going up . 	物价 上涨 了 。 
for here , or to go ? 	内用 还是 外带 ? 
if you see a mistake , then please correct it . 	如果 你 发现 错误 ， 那 就 请 你 纠正 它 。 
my baggage is missing . 	我 的 行李 丢 了 。 
it 's already 7:00 . 	已经 是 早上 七点 了 。 
what kind of woman do you think i am ? 	你 认为 我 是 哪种 女人 ？ 
that would be re@@ lev@@ ant . 	那会 有 关系 。 
i do n't know if he would have done it for me . 	我 不 知道 他 是否 已经 为 我 做好 了 。 
i love my life . 	我 爱 我 的 生命 。 
spring is my favorite season . 	春天 是 我 最 喜爱 的 季节 。 
i 'm not feeling that hungry yet . 	我 感觉 还 不是 那么 饿 。 
it 's almost time for the cherry blo@@ sso@@ ms . 	几乎 是 樱花 绽 放 的 时候 了 。 
is it ok if i go out with tom ? 	我 跟 汤姆 外出 行 吗 ？ 
i ca n't stand this noise any longer . 	我无法 再 忍受 这个 噪音 了 。 
i need a pencil . can i use one of yours ? 	我 需要 一支 铅笔 ， 我能 用 你 的 其中 一支 吗 ？ 
let me read the paper when you have finished with it . 	报纸 看 完后 借 我 看 下 。 
she 's asking how that 's possible . 	她 问 这 怎么 可能 。 
the city was destroyed by fire . 	这个 城市 毁 于 火灾 。 
this is very good so@@ il . 	这是 非常 好 的 土壤 。 
how much time is left ? 	还 剩 多少 时间 ？ 
tom is an ex@@ tra@@ ordinary man . 	汤姆 是 个 不 寻常 的 人 。 
are you going to attend the meeting ? 	你 要 参加会议 吗 ？ 
someone came . 	有人 来 了 。 
i do n't know where he lives . 	我 不 知道 他 住 在 哪里 。 
could you show me this bag ? 	你 能给 我 看看 这个 包 吗 ？ 
she got good grades in english . 	她 的 英文 成绩 很 好 。 
give us a ride downtown . 	载 我们 到 市区 。 
i 'm proud of my son . 	我 为 我 儿子 感到 骄傲 。 
our team lost all of its games . 	我们 的 队伍 输 了 所有 的 比赛 。 
he has a lot of money . 	他 有 很多 钱 。 
spring will come soon . 	春天 快来 了 。 
please drive the car more slowly . 	请 开车 开慢 一点 。 
i want to be a lawyer . 	我要 当律师 。 
tom 's birthday was yesterday . 	汤姆 的 生日 是 昨天 。 
do you know me ? 	你 认识 我 吗 ？ 
he was wounded in the war . 	他 是 在 战争 中 受伤 的 。 
we know that all men are mor@@ tal . 	我们 知道 人 皆 难免 一死 。 
please think it over . 	请 考虑 一下 。 
please close the door quietly . 	请安静 地 关门 。 
how soon can they be deli@@ ver@@ ed ? 	它们 什么 时候 能 被 送到 ？ 
why do n't you go home ? 	你 为什么 不 回家 呢 ？ 
you should run for city coun@@ ci@@ l . 	你 应该 去 竞选 城市 委员会 。 
she graduated from high school last year . 	去年 她 从 高中 毕业 了 。 
i work every day except sunday . 	我 除了 星期天 外 每天 都 上班 。 
i want to believe in tom . 	我要 相信 汤姆 。 
how many friends do you have ? 	你 有 多少 朋友 ？ 
they want this . 	他们 想要 这个 。 
she left here right away . 	她 马 上 离开 了 这里 。 
i made several mistakes in the exam . 	在 这次 考试 中 我 犯 了 几个 错误 。 
she for@@ gave the boy for his rudeness . 	她 原谅 了 男孩 的 粗鲁 。 
she is very pretty . 	她 很 可爱 。 
that 's the chair that i really like . 	那 是 我 真的 很 喜欢 的 椅子 。 
the company went bankrupt . 	公司 破产 了 。 
i need to get a stamp . 	我 需要 一张 邮票 。 
i did n't see him . 	我 没 见到 他 。 
he gave it to me for nothing . 	他 免费 把 它给 了 我 。 
what tom said does n't appl@@ y in this situation . 	汤姆 所言 不符 时局 。 
i hear he is good at mahjong . 	我 听说 他 打 麻将 很 厉害 。 
sit beside me . 	坐 我 旁边 。 
he pretended not to be listening . 	他 装作 没 在 听 。 
he has not been to france . 	他 从没 去过 法国 。 
i ca n't get away from work now . 	我现 在 上班 无法 离开 。 
do n't move , or i 'll shoot you . 	别动 ， 不然 我 就 开枪射 你 。 
they looked as if they would cry . 	他们 看 起来 好像 要 哭 了 。 
there is a basket under the table . 	桌子 底下 有 一个 篮子 。 
tom made some mistakes on the test . 	汤姆 在 考试 中犯 了 一些 错误 。 
what is your opinion on this matter ? 	关于 那个 你 有 什么 看法 ？ 
one of them is a sp@@ y . 	他们 其中 一人 是 间谍 。 
she is now staying at her uncle 's house . 	她 现在 正待 在 她 叔叔 家 。 
she is fond of playing tennis . 	她 酷爱 打 网球 。 
they stole apples from my or@@ c@@ hard . 	他们 从 我 的 果园 偷 了 苹果 。 
he makes it a rule to take a walk every morning . 	他 给 自己 定下 每天 早上 散步 的 规矩 。 
there 's no way to know . 	没有 办法 知道 。 
the sky is full of dark clouds . 	天空 乌云密布 。 
o@@ ga@@ i is his favorite author . 	Ogai 是 他 最 喜欢 的 作者 。 
she 'll love her husband forever . 	她 会永远 爱 她 的 丈夫 。 
you speak good english . 	你 的 英语 说 得 很 好 。 
many thanks . 	非常 感谢 ！ 
tom is very coura@@ ge@@ ous , is n't he ? 	汤姆 非常 勇敢 ， 不是 么 ？ 
tom showed us his new car . 	汤姆给 我们 看 他 的 新车 。 
i 'd rather stay at home . 	我宁愿 待 在家 里 。 
have you ever seen tom when he 's angry ? 	你 有 看见 过 汤姆生 气 的 时候 吗 ？ 
many people were killed in the war . 	很多 人 在 战争 中 被 杀 。 
perhaps he missed the train . 	他 可能 错过 了 火车 。 
help me lift the package . 	帮 我 擡起 这 包裹 。 
do n't be so carele@@ ss ! 	别 这么 粗心 ！ 
how was your trip ? 	你 的 旅行 怎么样 ? 
there are a lot of books in the library . 	图书馆里 有 很多 书 。 
i am lost . can you help me , please ? 	我 迷路 了 ， 能 不能 请 您 帮 我 一下 ？ 
speaking english is very difficult for me . 	说 英语 对 我 来 说 很 困难 。 
the lake is deepest at this spo@@ t . 	这里 是 湖 最深 的 地方 。 
what 's the exchange rate today ? 	今天 的 汇率 是 多少 ？ 
i can only speak for myself . 	我 只能 代表 我 自己 讲话 。 
she felt blue . 	她 感到 闷闷不乐 的 。 
everybody knows that he is honest . 	大家 都 知道 他 是 诚实 的 。 
give me something to write on . 	给我 一些 我 可以 在 上面 写字 的 东西 。 
such a thing ca n't happen in japan . 	这样 的 事情 不 可能 在 日本 发生 。 
the train arrived on schedule . 	火车 准时 到 了 。 
i understood everything tom said . 	我 明白 汤姆 所 说 的 一切 。 
this job pa@@ ys 10,000 yen a day . 	这个 工作 一天 有 10 , 000 日圆 的 报酬 。 
tom did n't know how to translate the word `` computer '' because the people he was talking to had never seen one . 	汤姆 不知 如何 翻译 “ 计算机 ” 一词 ， 因为 同 他 谈话 的 人 从未 见过 一台 。 
this is a wooden table . 	这 是 张 木桌 。 
the days are getting longer and longer . 	白天 渐渐 地 越来 越长 。 
you are no longer a m@@ ere child . 	你 不再 只是 一个 孩子 了 。 
tom says he 's tired . 	汤姆 说 他 累 了 。 
i love this song . 	我 爱 这 首歌 。 
he was born in africa . 	他 出生 在 非洲 。 
i hope that your brother is better . 	我 希望 你 弟弟 好点 了 。 
i know him by name , but not by sight . 	我 知道 他 的 名字 ， 但 不 知道 他长 什么样 。 
i 'd wear a hel@@ met . 	我要 戴头 盔 。 
i kind of lost my focus . 	我 有点 不能 集中 注意力 。 
you should do the hon@@ or@@ able thing and resign . 	你 应该 光荣 地 辞职 。 
whose is it ? 	这 是 谁 的 ？ 
he 's just gone on leave . 	他刚 请 假 走 了 。 
go away ! 	走开 ！ 
prices have dropped recently . 	最近 物价 已经 下降 。 
you had better be careful not to over@@ eat . 	你 最好 小心 不要 吃 过量 。 
stick with it and you 'll succeed . 	坚持 下来 ， 你 就 能 成功 。 
the boy who lives next door often comes home late . 	隔壁 的 男孩 常常 晚 回家 。 
i just could n't say no . 	我 就是 不能 说 不 。 
he left his son a large fortune . 	他 留给 了 他 的 儿子 一大 笔财富 。 
tom has a lot to think about . 	汤姆 要 考虑 很多 。 
my right hand is numb . 	我 的 右手 麻 了 。 
how about going out for dinner ? 	出去 吃 晚餐 如何 ？ 
i know how to make beef stro@@ g@@ an@@ off . 	我 知道 怎么 做 俄式 炒 牛肉 片 。 
is tom a good guy ? 	汤姆 是 好人 。 
tom still drinks , but not as much as he used to . 	汤姆 还是 喝 ， 但 不 像 以前 那么 多 了 。 
are you writing a letter ? 	你 在 写信 吗 ？ 
tom did well considering his age . 	考虑 到 他 的 年纪 ， 他 做 得 很 好 。 
the a@@ verage height of the girls in class is over 1@@ 5@@ 5 centi@@ meters . 	这个 班 的 女生 平均 身高 超过 了 155 公分 。 
welcome . 	欢迎 。 
i have to cook dinner today . 	我 今天 要 准备 晚饭 。 
he will be back soon . 	他 很快 就 会 回来 的 。 
is this your family ? 	这 是 你 的 家人 吗 ？ 
tom has no one to turn to for help . 	汤姆 没有 能 求助 的 人 。 
tom is n't complaining . 	汤姆 没有 抱怨 。 
the girl was sobbing in the corner of the sch@@ oo@@ l@@ room . 	女孩 在 教室 的 角落 啜泣 。 
we love tom . 	我们 爱 汤姆 。 
do you get up at six ? 	你 六点 起床 吗 ？ 
tom is a native french speaker . 	汤姆 是 法语 母语 者 。 
he is not as smart as his older brother . 	他 不 像 他 的 兄长 那样 聪明 。 
you must be at the station by 5 o'clock . 	五点 以前 你 必须 在 车站 。 
it 'll cost at least five dollars . 	它 至少 要花 五 美元 。 
where 's the boss ? 	老 板 在 哪里 ？ 
tom used to work here . 	汤姆 过去 在 这里 工作 。 
i 'm willing to share . 	我 乐意 分享 。 
he does n't live there anymore . 	他 不再 住 在 这里 了 。 
you ca n't count on their help . 	你 不能 指望 他们 的 帮助 。 
man can not live forever . 	人 无法 长生不死 。 
i 'd like to have this meat dish with your best white wine . 	我 想 在 吃 这肉 喝 你 最好 的 白酒 。 
i live in a big city . 	我 住 在 一个 大城市 里 。 
she 'll give her photo to whoever wants it . 	她 会 把 她 的 照片 给 想要 的 人 。 
could you say that in plain english ? 	你 会 说 简单 的 英语 吗 ？ 
i feel bad enough already . 	我 已经 感觉 够 坏 了 。 
my shoulder really a@@ ches . 	我 的 肩膀 很 酸 。 
i 'll attend the meeting . 	我将 参加 这个 会议 。 
they gave us very little trouble . 	他们 几乎 不给 我们 添麻烦 。 
let 's go and swim in the river . 	让 我们 去 河里 游泳 吧 。 
tom was all wor@@ n out . 	汤姆 完全 筋 疲力 尽 了 。 
they are much taller than us . 	他们 比 我们 高得 多 。 
this is n't what i ordered . 	这 不是 我点 的 食物 。 
tom wrote a letter to mary this morning . 	Tom 今天 早上 写 了 封信 给 Mary 。 
this is my mother . 	这 是 我 母亲 。 
please come over if you have time . 	如果 你 有 时间 的 话 ， 请过 来 一趟 。 
i always rely on him in times of trouble . 	我 在 困难 时 总 是 依赖 他 。 
sorry , but can you show me the way to the next village ? 	能 不能 麻烦 你 告诉 我 去 邻村 怎么 走 ？ 
once again . 	再 一次 。 
she always gets her own way . 	她 总 是 随心 所欲 。 
we know everything . 	我们 什么 都 知道 。 
we 'll take part in the mar@@ a@@ th@@ on . 	我们 将 参加 马拉松 。 
i like wearing long skirts . 	我 喜欢 穿长 袜 。 
try to keep from crying . 	试著 不要 哭 。 
were you in boston last summer ? 	你 上 个 夏季 在 波士顿 吗 ？ 
be@@ e@@ tho@@ ven was a great musi@@ cian . 	贝多芬 是 一个 伟大 的 音乐家 。 
she de@@ cor@@ ated her room with roses . 	她 用 玫瑰花 装饰 了 她 的 房间 。 
they both cried after hearing the tra@@ gic news . 	听到 这件 悲剧 ， 他 俩 尽 皆 哭泣 。 
my father is too busy to take a walk . 	我父 亲太忙 而 无法 去 散步 。 
what will tomorrow 's weather be like ? 	明天 天气 怎么样 ？ 
i forgot . 	我 忘 了 。 
see you at the party . 	在 派 对 上 见 。 
she has a strong wish to work as an interpreter . 	她 非常 想当 口译 。 
i made other plans . 	我 另 有 计划 。 
she does n't like people who are n't punctual . 	她 不 喜欢 不 守时 的 人 。 
the soldiers are ready for battle . 	士兵 们 准备 好 要 战斗 了 。 
tell me about some of the places you 've visited . 	给 我 说 说 你 去过 的 一些 地方 。 
i belong to the swimming club . 	我 是 游泳 社的 成员 。 
we 'll talk about this later . 	我们 晚会 再 谈 这事 。 
let 's walk . 	我们 走走 吧 。 
this medicine will help you . 	这个 药会 帮助 你 。 
i ate breakfast in my pa@@ ja@@ mas . 	我 穿 著 我 的 睡衣 吃 早餐 。 
you should have warned him sooner . 	你 应该 要 更 快 警告 他 的 。 
it 's improved . 	它 有 改善 了 。 
i heard him coming down@@ stairs . 	我 听 见 他 下楼 的 声音 。 
this desk takes up too much room . 	这张 桌子 太 占 空间 了 。 
he lives across the street from us . 	他 住 在 我们 街 对面 。 
you may come if you like . 	如果 你 想 ， 你 可以 来 。 
does anyone here know where tom lives ? 	这里 有人 知道 汤姆住 在 哪里 吗 ？ 
i want you to go . 	我要 你 去 。 
what 's today 's date ? 	今天 几号 ？ 
he taught himself french . 	他 自学 法语 。 
this writer is russian . 	这个 作家 是 俄罗斯 人 。 
he 's busy with his homework now . 	他现 在 正忙 著 做 他 的 家庭 作业 。 
where is the vodka ? 	伏特加 在 哪里 ？ 
tom has n't lost his confidence . 	汤姆还 没有 失去 信心 。 
i saw a cat running after the dog . 	我见 一只 猫 追 着 狗 跑 。 
they have nothing to eat . 	他们 没有 东西 吃 了 。 
tom searched inside the closet . 	汤姆 搜查 了 衣柜 里面 。 
tom got a late start this morning . 	汤姆 今早 出发 晚 了 。 
tomorrow 's weather should be sun@@ ny with occasion@@ al rain . 	明天 天气 晴转 阵雨 。 
i read a book last night . 	我 昨晚 读书 。 
i must re@@ pay the debt . 	我 必须 偿还 债务 。 
we 're fighting against time . 	我们 在 跟 时间 斗争 。 
i just got your letter yesterday . 	我 昨天 刚 收到 你 的 信 。 
we just need a plan . 	我们 只是 需要 个 计划 。 
tom has been learning french for a few years . 	汤姆 学了 几年 法语 。 
this directly concer@@ ns you . 	这 与 你 有 直接 关系 。 
i have a sore throat . 	我 喉咙 痛 。 
she returned the book to the library . 	她 把 书 还给 了 图书馆 。 
is that your car ? 	那 是 你 的 车吗 ? 
i bet ten dollars on that horse . 	我 在 那匹马 下 十 美元 的 赌注 。 
he is rotten to the cor@@ e . 	他坏 透 了 。 
how lovely ! 	多 可爱 啊 ！ 
quite a few americans like sushi . 	不少 的 美国 人喜 欢寿司 。 
we 're not in boston . 	我们 不 在 波士顿 。 
ca n't you discount it a little ? 	你 不能 打一点 折 吗 ？ 
tom just got divorced , too . 	汤姆 也 刚离婚 。 
we 're nex@@ t-@@ door neighbors . 	我们 是 隔 着 墙 的 邻居 。 
i do n't care if it snows . 	我 不在乎 是否 下雪 。 
i have a daughter . 	我 有 一个 女儿 。 
i refuse to be treated like a child . 	我 拒绝 被 像 一个 孩子 般 对待 。 
do you believe what he said ? 	你 相信 他 说 的 话 吗 ？ 
turn right . 	向 右 转 。 
i received her letter yesterday . 	昨天 我 收到 了 她 的 信 。 
i did n't even know tom had left . 	我 甚至 不 知道 汤姆离 开 了 。 
it was mar@@ i@@ e curi@@ e who discovered radi@@ um . 	镭 是 居里夫人 所 发现 的 。 
where would you like to go first ? 	你 想 先去 哪里 ? 
soccer is my favorite sport . 	足球 是 我 最 喜欢 的 运动 。 
i have breakfast at seven . 	我 在 七点 吃 早饭 。 
take it easy . 	放 轻 松 。 
one of my suit@@ ca@@ ses is missing . 	我 的 其中 一个 行李 不见 了 。 
tom had a lot of problems at the school . 	汤姆 在 学校 遇到 了 很多 问题 。 
send for a doctor at once . 	立即 送医 。 
i wonder why kar@@ a@@ o@@ ke is so popular . 	我 不 知道 为 什么 卡拉 OK 如此 受欢 迎 。 
it 's already nine o'clock . 	已经 9 点 了 。 
open your mouth and close your eyes . 	张开 嘴巴 闭上 眼睛 。 
she decl@@ ared that she was not guilty . 	她 声称 自己 没罪 。 
you 're quite forge@@ tful . 	你 很 健忘 。 
i 'm a free man . 	我 是 一个 自由 的 人 。 
i 've heard that name somewhere before . 	我 在 别处 听过 那个 名字 。 
tom asked mary where she 'd put the key . 	汤姆 问玛丽 她 把 钥匙 放在 哪里 了 。 
it 's ok not to eat it . 	你 不吃 没关 系 。 
she cleaned her room in a hurry . 	她 急忙 地清 扫 了 她 的 房间 。 
he has plenty of money in the bank . 	他 在 银行 里 有 大量 钱财 。 
they sometimes help us . 	他们 有 时 帮 我们 。 
thank you for invi@@ ting me to dinner . 	谢谢 你 邀请 我 吃饭 。 
you 'd better not see her now . 	你 最好 不要 再见 她 了 。 
i think i understand . 	我 想 我 懂 了 。 
it is less mu@@ g@@ gy today than it was yesterday . 	今天 不比 昨天 闷热 。 
you look stupid . 	你 看上去 很 傻 。 
old people get up very early . 	老人 们 很 早就 起床 。 
it 's obvious why his stomach hurts . 	他 为 什么 会 胃痛 的 原因 很明显 。 
broccoli is one of the healthiest vegetables . 	西蓝花 是 最 健康 的 蔬菜 之一 。 
how tall are your parents ? 	你 的 父母 有 多 高 ？ 
we had a heavy rain last night . 	昨晚 下 了 一场 大雨 。 
bird watching is a nice hobby . 	观察 鸟类 是 个 很 好 的 业余 爱好 。 
the prince fell in love with a woo@@ d@@ cu@@ tter 's daughter . 	王子 爱上 了 一个 樵夫 的 女儿 。 
i 've always wanted to do that . 	我 一直 都 想 做 。 
the apple was eaten by me . 	我 吃 苹果 。 
chinese is a to@@ nal language . 	汉语 是 一个 声调 语言 。 
i was n't alone then . 	我 当时 不 孤单 。 
it is more ble@@ ssed to give than to receive . 	赠与 比 接受 更 让 人 觉得 幸福 。 
you can swim , ca n't you ? 	你 会 游泳 , 不是 吗 ？ 
i can cook you something if you 're hungry . 	要是 你 饿 了 ， 我能 给 你 做饭 。 
there was no money for re@@ building . 	没有 重建 的 钱 。 
all their secrets have been re@@ v@@ ea@@ led . 	他们 所有 的 秘密 都 已经 被 揭晓了 。 
mary grabbed her purse and left . 	Mary 霸占 了 她 的 包包 并且 离开 了 。 
i got my hair cut . 	我 把 我的头 发 剪 了 。 
he is un@@ fit to be a teacher . 	他 不 适合 当 老师 。 
they never give up . 	他们 永不 言弃 。 
children sometimes lack patience . 	孩子 通常 没有 耐心 。 
that meat is chicken . 	那个 肉 是 鸡肉 。 
he 's accustomed to traveling . 	他 习惯 了 旅行 。 
how interesting ! 	多么 有趣 啊 ！ 
i just ate sushi and drank beer . 	我刚 才 吃 了 寿司 喝 了 啤酒 。 
have you ever climbed mt . yar@@ i ? 	你 曾 爬 过枪岳 吗 ? 
we work in a factory . 	我们 在 一个 工厂 工作 。 
tom wants to talk . 	汤姆 想 说话 。 
you should drink a lot of liquid . 	你 应该 喝 大量 的 液体 。 
there was no water in the well . 	这口 井里 没 有 水 。 
the boy is kind . 	他 是 个 好孩子 。 
i am thinking of going abroad . 	我 在 考虑 出国 。 
you 're still too young to get a driver 's license . 	你 还太年 轻无法 取得 驾驶 执照 。 
my shoulder hurts . 	我 肩膀 痛 。 
wo n't you have some coffee ? 	你 不要 点 咖啡 吗 ？ 
tom wanted re@@ ven@@ ge . 	汤姆想 报仇 。 
people ca n't live forever . 	人 无法 长生不死 。 
tom does n't believe he could do that . 	汤姆 不 相信 他 能 做到 。 
tom told me to take good care of myself . 	汤姆 告诉 我要 照顾 好 我 自己 。 
swi@@ tch on the light . i ca n't see anything . 	把 灯 打开 。 我 什么 都 看 不见 了 。 
they have an@@ nounced their enga@@ gement . 	他们 已经 宣布 订婚 了 。 
the dress fits you very well . 	这条 裙子 你 穿着 很 合身 。 
we have no time . 	我们 没 时间 。 
let your uncle think about it . 	让 你 叔叔 想 一想 。 
i hope tom 's pre@@ dicti@@ ons are wrong . 	我 希望 汤姆 的 预测 是 错 的 。 
are you coming tomorrow ? 	你 明天 要来 吗 ？ 
i just do n't like it . 	我 只是 不 喜欢 它 。 
i thought the questions were easy . 	我 认为 这些 问题 很 容易 。 
he speaks french fluently . 	他 说 法语 说 得 很 流利 。 
follow me . 	请 跟 我 来 。 
how do you pronounce your name ? 	你 怎么 念 你 的 名字 ？ 
leaves begin to fall in october . 	树叶 在 十月 开始 掉落 下来 。 
he came to my rescu@@ e . 	他 拯救 了 我 。 
i have a feeling he is right . 	我觉 得 他 是 对 的 。 
he told us such a funny story that we all laughed . 	他 给 我们 讲 了 一个 有趣 的 故事 ， 我们 都 笑 了 起来 。 
she did n't think so . 	她 不 这么 想 。 
i can help you out . 	我能 帮 你 。 
put it out of your mind . 	别去 想 它 。 
i think that it 's true . 	我 认为 这是 真的 。 
cooki@@ e 's mother died of cancer . 	Cookie 的 母亲 死 于 癌症 。 
i 'm sure tom ca n't swim . 	我 确定 汤姆 不会 游泳 。 
would you lend me your bicycle ? 	你 可以 借 我 你 的 脚踏车 吗 ? 
do you have medical insurance ? 	你 有 医疗 保险 吗 ？ 
she lives in a t@@ wo@@ -@@ story house . 	她 住 在 一栋 两层 楼 的 房子 。 
i do n't feel well . 	我 感觉 不 舒服 。 
i agree completely . 	我 完全 同意 。 
she cried when she heard the news . 	当 她 听 到 这个 消息 的 时候 ， 她 哭 了 。 
tom s@@ nea@@ ked up behind mary . 	汤姆 鬼鬼祟祟 地 遛 近 了 玛丽 身后 。 
let me in . 	让 我 进去 。 
let 's go now . 	我们 现在 去 吧 。 
english is taught in most countries . 	英语 在 大部份 的 国家 被 教授 。 
i 'll be back late . 	我会 晚一点 回来 。 
my school is on the left . 	我 的 学校 在 我家 左边 。 
i plan to stay at home all day tomorrow . 	我 打算 明天 在 家里 待 一天 。 
did you remember that you were supposed to buy can@@ dles ? 	你 记得 自己 该 买 蜡烛 吗 ？ 
i 'm sa@@ ving up to buy a new car . 	我 在 省钱 买 新车 。 
there was no water in the river . 	河里 没 有 水 了 。 
she gave me a mean@@ ing@@ ful look . 	她 意味 深长 地 看 了 我 一眼 。 
i have nothing to complain about . 	我 没 有 什么 可 抱怨 的 。 
smoking is not permi@@ tted on the train . 	不允许 在 火车 上 吸烟 。 
everything went black . 	一切 都 变成 了 黑色 。 
i want to buy something to eat . 	我想 买点 东西 吃 。 
i want you to tell me the truth . 	我 想 你 把 真相 告诉 我 。 
he never looks down on poor people . 	他 从 未 看不起 穷人 。 
would you please wait for a few minutes ? 	请 您 等 几分钟 好 吗 ？ 
she is already sleeping . 	她 已经 睡下 了 。 
this book of his is n't interesting at all . 	他 的 这 本书 一点 意思 也 没有 。 
i do n't know whether i have time or not . 	我 不 知道 有没有 时间 。 
do you not understand basic logic ? 	你 不 懂 基本 逻辑 吗 ？ 
i wake him up at 6 every morning . 	我 每天 早上 6 点 叫醒 他 。 
i do n't have a car . 	我 没 有 汽车 。 
it is clear what must be done . 	显然 地势 必要 做些 什么 。 
i ca n't help feeling sorry for him . 	我 不禁 为 他 感到 难过 。 
his letter makes me un@@ easy . 	他 的 来信 让 我 不安 。 
we should call the police . 	我们 该 报警 。 
that wo n't ever happen . 	那 从 不会 发生 。 
what 's the last thing you remember ? 	你 能记 起来 的 最后 一件 事是 什么 ？ 
she 's just a child . 	她 只是 个 孩子 。 
his father dedicated his life to science . 	他 的 父亲 把 一生 奉献给 了 科学 。 
tom is on the bus to the city . 	汤姆 搭公车 去 市区 。 
we 're not looking . 	我们 没有 看著 。 
beer bottles are made of glass . 	啤酒瓶 是 玻璃 做 的 。 
she and i are brother and sister . 	我 和 她 是 兄妹 。 
you should have done so . 	你 本应 该 这样 做 的 。 
let 's go to the hospital now . 	我们 现在 就 去 医院 吧 。 
please open the bottle . 	请 打开 瓶子 。 
how long are you going to stay in japan ? 	你 会 在 日本 多久 ? 
my wish is to become a teacher . 	我 的 愿望 是 成为 一个 老师 。 
i do n't like science . 	我 不 喜欢 科学 。 
this dictionary is mine . 	这本 字典 是 我 的 。 
the students have returned . 	学生 们 回来 了 。 
she and i have nothing in common . 	我 和 她 没 有 共同 之处 。 
i agree with your opinion . 	我 同意 您 的 意见 。 
it does n't surprise me . 	这 并 不让 我 惊讶 。 
you know i 'm right . 	你 知道 我 是 正确 的 。 
i am in trouble . 	我 有 麻烦 了 。 
tom left his umbrella on the bus . 	汤姆 把 伞 落 在 了 巴士 上 。 
he wears glasses . 	他 戴 眼镜 。 
the car is waiting at the gate . 	车在 门口 等 著 。 
they were always making jokes . 	他们 一直 闹笑话 。 
we 'll have lived here for two years next april . 	到 明年 四月 我们 住 在 这儿 就 满 两年 了 。 
our baseball team is very strong . 	我们 的 棒球 队 很强 。 
nothing is missing . 	什么 也 没少 。 
i guess that would be all right . 	我 猜 那 应该 可以 的 。 
the things he says are enti@@ rely in@@ con@@ se@@ qu@@ enti@@ al . 	他 说 的话 根本 毫无 意义 。 
i 'm playing a tv game . 	我 在 玩 电视 游乐器 。 
please sit down . 	请 坐下 。 
he lives by himself in the woods . 	他 独自住 在 森林 里 。 
my boss made me work overtime . 	我 的 老 板 要 我 加班 。 
what does tom know about me ? 	汤姆 知道 我 的 什么 ？ 
your brother got married , did n't he ? 	你 哥哥 结婚 了 ， 不是 吗 ？ 
he was killed in a car accident . 	他 死 于 一场 车祸 。 
the lights are n't on . 	灯 没有 亮 着 。 
what are you doing ? 	你 做 什么 ？ 
how do i explain that to tom ? 	我 怎么 跟 汤姆 解释 ？ 
you 're going to wreck your eyesight if you play games all the time . 	要是 你老 打 游戏 的话 ， 你 的 视力 会 下降 的 。 
languages are n't his for@@ te . 	语言 不是 他 的 强项 。 
tom was dressed like a pi@@ rate . 	Tom 穿 得 像 个 海盗 。 
this book is hard for me to read . 	这 本书 对 我 来说 很 难读 。 
she is an ob@@ stin@@ ate girl . 	她 是 个 倔强 的 女孩 。 
i am at home . 	我 在家 。 
everyone wants what they ca n't have . 	每个 人 都 想要 得到 无法 拥有 的 东西 
can i talk to you priva@@ tely for a minute ? 	我能 跟 你 私下 谈 一分钟 吗 ？ 
i laughed . 	我 笑 了 。 
please drive carefully . 	请 小心 驾驶 。 
i 'm tired of watching television . 	我 看 电视 看到 厌烦 了 。 
you should re@@ write this sentence . 	你 应该 重写 这句 话 。 
tom did n't let his children go to mary 's party . 	汤姆 没 有 让 他 的 孩子 们 去 玛莉 的 派 对 。 
tom did n't need to finish that work by today . 	汤姆 不必 今天 就 完成 那 工作 。 
how did your test go ? 	你 的 测验 怎么样 ？ 
this is my wife . 	这 是 我 的 妻子 。 
he 's used to traveling . 	他 习惯 了 旅行 。 
tom is n't accustomed to walking bar@@ e@@ foo@@ ted . 	汤姆 不 习惯 光着 脚 漫步 。 
i am eating rice . 	我 在 吃 米饭 。 
do you plan to go abroad ? 	你 打算 出国 吗 ？ 
you should go and brush your teeth . 	你 该 去 洗牙 了 。 
his respon@@ se was con@@ tr@@ ary to our expectations . 	他 的 回应 出乎 我们 的 意料 。 
tom got first prize , did n't he ? 	汤姆得 了 第一名 ， 不是 吗 ? 
tom 's french is already rather good . 	汤姆 的 发育 已经 很 好 了 。 
i ca n't follow his logic . 	我 无法 理解 他 的 逻辑 。 
the policeman a@@ imed his gun at the man . 	警察 瞄准 了 那个 男人 。 
tom ad@@ ded both his and mary 's name to the list . 	汤姆 将 他 自己 和 玛丽 的 名字 添加 到 了 名单 上 。 
this makes me happy . 	这让 我 开心 。 
are you ready ? 	你们 准备 好 了 吗 ？ 
i do n't have the slightest intention of reti@@ ring . 	我 没有 一点 退休 的 念头 。 
is there anything you ca n't do ? 	有 你 不能 做 的 事 吗 ？ 
that 's what i hope . 	我 希望 如此 。 
there is only one book on the desk . 	桌子 上 只有 一 本书 。 
that 's logi@@ cal . 	那 符合 逻辑 。 
do you want to hear it ? 	您 想 听 它 吗 ？ 
i 'm too drunk to do that . 	我 喝醉 了 ， 做 不到 。 
he has been secre@@ tly in love with her . 	他 一直 暗恋 着 她 。 
why should anyone be surprised ? 	为什么 任何人 应该 感到 惊喜 ？ 
she has to take a reme@@ di@@ al course in english . 	她 需要 上 英语 补习班 。 
the doctors are looking at an x-@@ ray . 	医生 在 观察 X 光片 。 
the man reading a paper over there is my uncle . 	在 那儿 看 报纸 的 男人 是 我 叔叔 。 
your behavior leaves much to be desi@@ red . 	你 的 行为 离 要求 的 太远 了 。 
he was able to solve the problem . 	他 能 解决 这个 问题 。 
careless@@ ness can lead to a serious accident . 	粗心大意 可能 导致 严重 的 事故 。 
what were you and tom doing yesterday ? 	你 和 汤姆 昨天 做 了 什么 ？ 
he leaves for school at seven . 	他七点 钟去 学校 。 
i have a lot of friends to help me . 	我 有 很多 朋友 帮 我 。 
i 'm going to see what i can do . 	我要 看看 我能 做 甚么 。 
you can get from wa@@ sh@@ ing@@ ton to new york by train . 	你们 可以 乘 火车 从 华盛顿 去 纽约 。 
would you mind my opening the door ? 	你 介意 我 开门 吗 ? 
i invited my friends to dinner . 	我 邀 请 我 的 朋友 吃 晚餐 。 
the police seem to know exactly where we are . 	警察 看来 很 清楚 我们 在 哪里 。 
she kept the secret to herself . 	她 守 著 这个 秘密 。 
that was really un@@ fair . 	那真 不 公平 。 
they gave a big party for me . 	他们 为 我 办 了 一个 盛大 的 派 对 。 
she bought two pairs of socks . 	她 买 了 两双 袜子 。 
it ca n't be ! 	这 不 可能 ！ 
he is good at ru@@ g@@ by . 	他 很 擅长 橄榄球 。 
i ca n't let you give me your last ten dollars . 	我 不能 让 你给 我 你 最后十美圆 。 
`` shall i have him call you when he gets back ? '' `` yes , please . '' 	“ 等 他 回来 ， 我要 让 他 给 你 打电话 吗 ？ ” “ 是 的 ， 谢谢 。 ” 
i always enjoy listening to classical music in my free time . 	有空 的 时候 ， 我 总 喜欢 听 古典 音乐 。 
how can i get to the police station ? 	我 怎么 去 警察局 ？ 
my uncle lives in an apartment . 	我 叔叔 住 在 公寓 里 。 
i 'm very sorry i came home so late . 	我 很 抱歉 那么 晚 回家 。 
i dislike big cities . 	我 不 喜欢 大城市 。 
he majored in drama at college . 	他 在 大学 主修 戏剧 。 
what 's your name ? 	你 叫 什么 名字 ？ 
no , i did n't write it . 	不 ， 我 没 写 。 
tom practiced in front of the mirror . 	汤姆 在 镜 前练习 。 
i attempted to solve the problem . 	我试 图解决 这个 问题 。 
would you please lend me some money ? 	你 能 借 我些 钱 吗 ？ 
they have jobs . 	他们 有 工作 。 
he occasionally visited me . 	他 偶尔 会来 拜访 我 。 
tell me your story . i am all ears . 	告诉 我 你 的 故事 。 我会 注意 听 。 
you did n't tell me you worked for tom . 	你 没 告诉 我 你 为 汤姆 工作 。 
we may need some . 	我们 可能 需要 一些 。 
look at that house . 	看 那个 房子 。 
i 'll have to think about it . 	我 将 考虑 考虑 。 
she prefers beer to wine . 	她 喜欢 啤酒 胜过 葡萄酒 。 
she has a little bread . 	她 有点儿 面包 。 
i attended the meeting yesterday . 	昨天 我 出席 了 会议 。 
i have so many clothes i do n't know what to wear tomorrow . 	我 有 那么 多 衣服 ， 以至于 我 不 知道 明天 穿 什么 了 。 
as long as you keep quiet , you can stay here . 	只要 你 保持 安静 , 你 可以 留在 这里 。 
we watched them play baseball . 	我们 看著 他们 打 棒球 。 
do n't leave ! 	别 走 ！ 
i have to go to the bank . 	我 必须 到 银行 去 。 
i am proud of my father . 	我 为 我 父亲 而 自豪 。 
she named all the flowers in the garden . 	她 给 花园里 的 花都 起 了 名字 。 
she gave me these old co@@ ins . 	她给 了 我 这些 旧 硬币 。 
we felt the house shake a little . 	我们 感觉 到 房子 摇动 了 一下 。 
we saw the children enter the room . 	我们 看到 了 孩子 们 进入 这个 房间 。 
selling cars is my job . 	卖车 是 我 的 工作 。 
if we do n't keep walking we 'll be late . 	再 不 走 就 迟到 了 。 
it was beginning to snow . 	开始 下雪 了 。 
what do you two do for fun ? 	你们 两个 做 了 什么 有趣 的 事情 呢 ？ 
she began to sing . 	她 开始 唱歌 了 。 
i saw tom almost every day last week . 	我 上周 几乎 天天 见 到 汤姆 。 
you sing like an an@@ ge@@ l . 	你 唱歌 像 天使 。 
he studied hard . 	他 努力 学习 。 
this is my sister . 	这 是 我 的 妹妹 。 
he loves traveling . 	他 爱 旅行 。 
tom went back to his bedroom . 	汤姆 回到 了 他 的 卧室 。 
he is angry with you . 	他 在 生 你 的 气 。 
stop reading . 	别 再念 了 。 
you do n't have to talk so loud . 	你 不必 这么 大声 说 话 。 
i do n't go to school on sundays . 	我 周日 不去 学校 。 
to my knowledge , she has n't married yet . 	据 我 所知 ， 她 还没 结婚 。 
he told me that whatever might happen , he was prepared for it . 	他 告诉 我 不论 发生 什么 ， 他 都 准备 好 了 。 
do n't leave me here alone . 	别 把 我 一个 人 留在 这里 。 
he went by bicycle . 	他 骑 自行车 去 的 。 
i 'd like to go with tom . 	我 想 跟 汤姆 走 。 
nobody believes what i say . 	没有 人 相信 我 说 的话 。 
hold fire . 	停火 。 
leave my car alone . 	离 我 的 车远 一点 。 
they ste@@ pped a few pac@@ es forward . 	他们 前进 了 几步 。 
what nonsense are you talking now ? 	你 胡说 什么 呢 ？ 
i 'll see you a week from today . 	我 下星期 的 今天 会 和 你 见面 。 
he tends to be late for meetings . 	他 开会 往往 会迟 到 。 
what vegetables do you like to eat ? 	你 喜欢 吃 什么 菜 ？ 
do you want rice ? 	你们 要 米 饭 吗 ？ 
she 's already sleeping . 	她 已经 睡下 了 。 
you 'd better not wait here . 	你 最好 不要 在 这里 等 。 
leave this to me . 	把 这个 留给 我 吧 。 
i 'm bored . 	我觉 得 很 无聊 。 
i do n't know if i can do it . 	我 不 知道 我能 不能 做 。 
a boy of seventeen is often as tall as his father . 	十七 岁 的 男孩 常常 长 得 和 他 父亲 一样 高 。 
let 's drink coffee while we talk . 	让 我们 边 喝 咖啡 边谈 。 
do you have any money with you ? 	你 身上 有 钱 吗 ？ 
i 'll be seventeen next year . 	我 明年 17 岁 。 
`` is he going to swim tomorrow ? '' `` yes , he is . '' 	" 他 明天 会 去 游泳 吗 ? " " 是 的 , 他会 。 " 
we 're special . 	我们 是 特别 的 。 
are n't you happy ? 	你 不快 乐 吗 ? 
i sometimes break the rules . 	我 有时候 打破 规矩 。 
she took care of my dog . 	她 照顾 了 我 的 狗 。 
pick up the pencil from the floor . 	从 地上 捡 起 这支 铅笔 。 
soldiers must carry out their orders . 	军人 必须 履行 他们 的 命令 。 
am i allowed to use this ? 	能 让 我 用 这个 吗 ？ 
i ca n't put up with his ar@@ rog@@ ance . 	我 不能 忍受 他 的 傲慢 。 
please show me around . 	请 带 我 到 处 看看 。 
watch out ! there 's a big hole there . 	小心 ！ 在 那里 有 一个 大洞 。 
children do n't like to go out in the dark . 	孩子 们 不 喜欢 摸黑 外出 。 
is your family doing well ? 	你 的 家人 好 么 ？ 
she has a gift for pro@@ phe@@ cy . 	她 有 预言 的 能力 。 
what tom really wanted was enough money to buy mary some flowers . 	汤姆 真正 想要 的 是 有 足够 的 钱 给 玛丽 买 一些 花 。 
breakfast is from seven to nine . 	早餐 时间 在 七点 到 九点 。 
i 'd rather be with you . 	我 更 愿意 跟着 你 。 
what are you writing ? 	你 在 写 什么 ？ 
do n't put anything on top of the box . 	盒子 上面 不要 放 任何 东西 。 
tom has lost his interest in studying french . 	汤姆 已经 对学 法语 不 感兴趣 了 。 
there were several rooms still vac@@ ant . 	还有 几间 空房 。 
she kissed him on the cheek . 	她 在 他 的 脸颊 上 吻 了 一下 。 
there are many fish in this lake . 	这 湖里 有 许多 鱼 。 
i work with her boyfriend . 	我 和 她 的 男朋友 在 一起 上班 。 
she married a rich man . 	她 嫁 给 了 一个 有钱人 。 
they were worried . 	他们 担心 。 
i do n't care . 	我 无所谓 。 
if you bite me , i 'll bite back . 	如果 你 咬 我 ， 我 就 咬 回来 。 
you do n't have to take an examination . 	你 不 需要 考试 。 
my attitude towards him changed . 	我 对 他 的 态度 变 了 。 
spanish is spoken in twenty countries . 	有 二十 个国家 说 西班牙 语 。 
she was in a hurry . 	她 在 赶时间 。 
he often sits for many hours reading books . 	他 常常 坐 着 看书 一连 好几个 小时 。 
i resign . 	我 放弃 。 
do n't leave the tv on . 	不要 让 电视机 开着 。 
who were you talking to ? 	你 和 谁 说话 呢 ？ 
i had a tennis match with him . 	我 曾 与 他 的 比赛 网球 。 
i think i 'll be able to deal with that . 	我 认为 我能 做好 。 
cities are exciting places , but also stre@@ ssful . 	城市 是 令人 兴奋 的 地方 ， 但 也 会 让 人产生 压力 。 
many people only speaks one language . 	许多人 只 说 一种 语言 。 
who wants hot chocolate ? 	谁 要 热 巧克力 ？ 
which book is better ? 	哪 一本 书比 较 好 ？ 
who is your english teacher ? 	你 的 英语 老师 是 谁 ？ 
good night . 	晚安 。 
could you sign here ? 	你 能 在 这里 签名 吗 ? 
the warnings were ignored . 	警告 被 忽视 。 
what do you do here ? 	你 在 这里 做 甚么 ？ 
why did you come here so early ? 	你 为 什么 这么 早来 这里 ？ 
i found the boy fast asleep . 	我 发觉 男孩儿 酣然 入睡 了 。 
can you come for dinner tonight ? 	你 今天 晚上 能来 吃 饭 吗 ？ 
do you have a red pencil ? 	你 有 红色 的 铅笔 吗 ？ 
he does n't know how to swim . 	他 不会 游泳 。 
what 's the point in doing that ? 	那样 做 有 什么 用 ? 
turn left at the next corner . 	下 一个 街角 左转 。 
do n't worry about such a thing . 	不要 担心 这样 的 事情 。 
i can make that happen . 	我 不能 让 那事 发生 。 
we enjoyed ourselves at the party . 	我们 在 派 对 上 玩 得 很 开心 。 
we have to stop the ble@@ eding . 	我们 必须 止血 。 
beauty is but skin deep . 	美貌 只是 表面 性 的 东西 。 
my father can not lift it up . 	我父 亲无法 擡起 它 。 
two months have passed since he left for france . 	自从 他 离开 去 法国 ， 已经 有 两个 月 了 。 
i ca n't put up with it . 	我 无法 忍受 它 了 。 
when did you last see tom ? 	你 最后 一次 看到 汤姆 是 什么 时候 ？ 
i have no objection to paying a special fee if it is necessary . 	如果 必要 的话 ， 我 不 反 对付 特别 费用 。 
spring is just around the corner . 	春天 快来 了 。 
tom is a c@@ lever kid . 	汤姆 是 聪明 的 孩子 。 
i could answer all the questions . 	我 可以 回答 所有 问题 。 
fire is always dangerous . 	火是 非常 危险 的 。 
i 'm completely exhausted . 	我 完全 地筋 疲力 尽 了 。 
may i see your passport ? 	我 可以 看看 你 的 护照 吗 ？ 
we are encouraged to use our imagination . 	我们 被 鼓励 使用 想像力 。 
i@@ cel@@ and used to belong to den@@ mark . 	冰岛 以前 属于丹麦 。 
would you carry my luggage upstairs ? 	你 可以 把 我 的 行李 拿到 楼上 吗 ? 
he is one of my neighbors . 	他 是 我 的 一个 邻居 。 
everyone admi@@ res the pictures painted by him . 	每个 人 都 很 欣赏 他 所画 的 图画 。 
in japan , the new school year begins in april . 	日本 的 新学年 在 四月 开始 。 
a few years ago , our room had little furniture in it . 	几 年前 ， 我们 的 房间里 没有 什么 家具 。 
mary bought a skirt and a bl@@ ouse . 	玛丽 买 了 一件 衬衫 和 一条 连衣裙 。 
i do my homework after school . 	我 在 放学 后 做作 业 。 
would three o'clock be all right ? 	三点钟 可以 吗 ？ 
a new team was for@@ med in order to take part in the boat race . 	为了 参加 划船 比赛 ， 一支 新 的 队伍 组成 了 。 
pa@@ ce yourself . 	量力而行 。 
harvard was founded in 16@@ 3@@ 6 . 	哈佛 始建 于 1636 年 。 
i do n't know anything about their relationship . 	我 对 他们 的关 系 一 无 所知 。 
tom was afraid to ask for help . 	汤姆 不敢 求助 。 
it 's my job . 	这是 我份 内 的 事 。 
waiter , please bring me some water . 	服务生 ， 请给 我 一些 水 。 
what 'll you be doing over the weekend ? 	你 整个 周末会 做 什么 ？ 
she as@@ signed the work to him . 	她 把 这个 工作 派给 他 做 。 
his plan is dangerous ! 	他 的 计划 是 危险 的 ！ 
tom , i want to have a chat with you . 	Tom ， 我 想 和 你 谈谈 。 
i found the co@@ mic book very interesting . 	我 发现 这本 漫画 书 非常 有趣 。 
somebody 's got to do something . 	得 有人 做点 什么 。 
are you meeting someone here ? 	你 在 这里 是 要 见 谁 吧 ？ 
please take your shoes off . 	请脱 掉 你 的 鞋子 。 
boston is a wonderful city . 	波士顿 是 一座 非常 好 的 城市 。 
i 'm from singapore . 	我 是从 新加坡 来 的 。 
i think we should n't let tom do that again . 	我 认为 我们 不该 让 汤姆 再 那么 做 。 
they arrived late because of the storm . 	因为 风暴 ， 他们 晚到 了 。 
he wo n't live a long life . 	他 不会长 寿 。 
why do n't you give it another try ? 	你 为 什么 不再 试 一次 ? 
you wo n't be happy no matter what i do . 	无论 我 做 什么 ， 你 都 不 高兴 。 
we should call the doctor . 	我们 应该 去 请 医生 。 
stop re@@ sist@@ ing ! 	停止 抵抗 ！ 
my fingers are so numb with cold that i ca n't play the piano . 	我 的 手指 冻僵 了 ， 以至于 无法 弹 钢琴 了 。 
tom complained that mary never helped him . 	汤姆 埋怨 玛丽 从来不 帮 他 。 
all you can do is to wait . 	所有 你 能 做 的 就是 等待 。 
you have to hurry . 	您 要 赶快 些 。 
he has a good comm@@ and of english . 	他 有 很 好 的 英语 能力 。 
watch out ! 	当心 ！ 
just take my word for it . 	请 相信 我 的 话 。 
which club do you belong to ? 	你属 于 哪个 社团 ? 
this is considered to be a matter of great import@@ ance . 	这 被 认为 是 一件 大事 。 
tom wasted time . 	汤姆浪费 时间 。 
almost no one believes her . 	几乎 没人 相信 她 。 
walk ahead of me . 	在 我 前面 走 。 
i do n't want there to be any mis@@ understanding . 	我 不想 有 任何 误会 。 
what do you think of japanese food ? 	你 觉得 日本 料理 怎么样 ？ 
the number of traffic acci@@ dents seems to be on the increase . 	交通事故 的 数量 似乎 在 增长 。 
the old man lived there by himself . 	这个 老人 独自住 在 那里 。 
good morning . 	早上 好 ！ 
someone stole my wallet on the train . 	有人 在 火车 上 偷 了 我 的 钱包 。 
you should take care of your sick mother . 	你 应该 照顾 你 生病 的 母亲 。 
please stop that right now . 	请 即刻 停止 。 
that 's a huge cha@@ ll@@ en@@ ge . 	这是 一个 巨大 的 挑战 。 
it has nothing to do with you . 	跟 你 没 有关 系 。 
he might change his mind . 	他 可能 会 改变 心意 。 
there was a minute of silence and then everybody started s@@ crea@@ ming . 	有 一分钟 的 沉默 ， 然后 每个 人 都 开始 尖叫 。 
shakespeare is the name of a writer . 	莎士 比亚 是 一位 作家 的 名字 。 
what have you come here for ? 	你 为什么 来 这儿 ？ 
when will we go ? 	我们 甚么 时候 出发 ? 
but you 're not there . 	但 你 不 在 那里 。 
tom knows me . 	Tom 认识 我 。 
we have to sing at an old fol@@ ks home today . 	我们 今天 得 去 养老院 唱歌 。 
i want something sweet . 	我要 一些 甜 的 东西 。 
i wonder if they 'll get divorced . 	我 不 知道 他们 是否 会离婚 。 
i want to go abroad next year . 	我 明年 想 去 国外 。 
i asked twenty friends to the party . 	我 请 了 二十 位 朋友 参加 派 对 。 
the baby is sleeping . 	宝宝 正在 睡觉 。 
i may have made a mistake . 	我 可能 搞错 了 。 
he 's good at flying kites . 	他 擅长 放风筝 。 
she was a genius in mathematics . 	她 是 个 数学 天才 。 
they grow flowers in the garden . 	他们 在 花园 里种 花 。 
a lot of students around the world are studying english . 	世界 上 许多学生 正在 学习 英语 。 
i 'll swim . 	我要 游泳 。 
do you think we 'll have good weather ? 	你 认为 我们 会 遇到 好 天气 吗 ？ 
tom wanted to know if mary had a boyfriend . 	汤姆 想 知道 玛丽 是否 有 男朋友 ？ 
classes begin next week . 	课程 下周 开始 。 
you should study harder . 	你 应该 更 努力 学习 。 
you 're too generous . 	你 太 大方 了 。 
he is getting along with his neighborhood . 	他 和 他 的 邻居 相处 。 
you can drive a car , ca n't you ? 	你会 开车 ， 不是 吗 ? 
you might have heard of it . 	你 可能 听说 过 。 
please come back as soon as possible . 	请 尽快 回来 。 
he 's not here yet . 	他 还没到 这里 。 
tom made his ser@@ v@@ ants eat in the dark . 	汤姆 让 他 的 仆人 们 在 黑暗 下 进餐 。 
the lake was frozen . 	湖冻 冰 了 。 
he became more ob@@ stin@@ ate as he grew older . 	他 年纪 越大变 得 越 顽固 。 
tom was a bit puzzled by mary 's answer . 	汤姆 被 玛丽 的 回答 困惑 了 一下 。 
tom is n't a very nice guy . 	汤姆 不是 个 多 好 的 人 。 
i am going to watch tv this evening . 	今天 晚上 我 打算 看电视 。 
i do n't know the meaning of this word . 	我 不 知道 这个 词 的 意思 。 
he got thro@@ wn out of the house . 	他 被 赶出 了 这栋 房子 。 
the little cab@@ in was bath@@ ed in moonlight . 	小 木屋 沐浴 在 月光 之中 。 
you made the mistake on purpose , did n't you ? 	你 故意 犯 这个 错 , 是 吗 ? 
you are not to leave this room . 	你 不 可以 离开 这个 房间 。 
do you have one ? 	你 有 吗 ？ 
i 'll act as a gui@@ de for you . 	我 为 你 充当 导游 。 
you may choose any of them . 	你 可以 选择 他们 之中 的 任何 一个 。 
the clo@@ wn made a funny face . 	小丑 做 了 个 鬼脸 。 
i expect your help . 	我 期待 你 的 帮助 。 
she looks very ele@@ g@@ ant . 	她 看上去 十分 优雅 。 
would you like to eat with us ? 	你 想 和 我们 一起 吃 吗 ？ 
can we talk in private ? 	我们 能 私下 谈谈 吗 ？ 
are you a high school student ? 	你 是 高中生 吗 ? 
they ate sandwiches for lunch . 	他们 午饭 吃 了 三明治 。 
i like coffee better than tea . 	我 喜欢 咖啡 胜过 茶 。 
i do n't want to lose you again . 	我 不想 再 失去 你 。 
ari@@ th@@ me@@ tic deals with nu@@ mbers . 	算数 处理 数字 。 
i had a nightmare . 	我 做 噩梦 了 。 
tom has made up his mind to go to boston to study . 	汤姆 已经 下定 决心 要 去 波士顿 念 书 。 
i think i 've found the answer . 	我 想 我 找到 答案 了 。 
we 'll stay quiet . 	我们 会 保持 安静 。 
she was scared to cross the road . 	她 怕 过马路 。 
you 're always busy . 	你 一直 忙 。 
do n't inter@@ rupt our conversation . 	不要 打断 我们 的 谈话 。 
you should make no@@ tes . 	你 应该 做 笔记 。 
you do n't have to go to school on sunday . 	你 没 必要 周日 去 上学 。 
women t@@ end to live longer than men . 	女人 往往 比 男人 活得 更长 。 
she insisted that i should see the doctor . 	她 坚持 让 我 去 看 医生 。 
he meets his girlfriend on saturdays . 	他 每 周六 和 他 的 女朋友 见面 。 
which way should we go ? 	我们 应该 往 哪个 方向 走 ？ 
are you taking any medicine regularly ? 	你 经常 服用 任何 药物 吗 ？ 
she is a pretty girl . 	她 是 一个 漂亮 的 女孩 。 
she played the guitar and he sang . 	她弹 吉他 ， 他 唱歌 。 
keep an eye on the bags . 	把 包包 看好 。 
my older sister often drinks tea with milk . 	我 的 姐姐 经常 就 着 牛奶 喝茶 。 
i usually got to bed about eleven . 	我 通常 约 十一 点钟 上床 睡觉 。 
people can easily tell the difference between them . 	人们 可以 很 容易 地 看出 其中 的 差别 。 
are you lost ? 	你 迷路 了 吗 ？ 
i play in a band . 	我 在 一个 乐团里 演奏 。 
tom is out of his mind . 	汤姆 失去 理智 了 。 
no matter where you go , i 'll follow you . 	无论 你 去 哪里 我 都 会 跟 著 你 。 
leave the book where it was . 	把 书 放在 原处 。 
what do you think he did ? 	你 觉得 他 这样 做 怎么样 ？ 
you have lovely eyes , do n't you ? 	你 有 一双 可爱的 眼睛 ， 不是 吗 ? 
tom wants me to stay away from him . 	Tom 要 我 离 他 远 一点 。 
how come you know so much about japanese history ? 	你 为 什么 知道 这么 多 的 日本 历史 ? 
i 'm married . 	我 结婚 了 。 
they became friends in ele@@ men@@ tary school . 	他们 在 小学时 就是 朋友 了 。 
it was so cold yesterday that i stayed home . 	昨天 太冷 了 ， 我 只好 待 在 家里 。 
this is a present for you . 	这是给 你 的 礼物 。 
i was embarrassed by what she said . 	她 说 的 话 让 我 觉得 很 尴尬 。 
i admit that he is right . 	我 承认 他 是 对 的 。 
grab a hold of the rope . 	抓住 绳子 。 
please enjoy yourself at the dance . 	请 尽情 地 跳舞 。 
tom wants children , but mary does n't . 	汤姆 想要 孩子 ， 但 玛丽 不想 。 
none of us thought he was to blame for the accident . 	我们 都 不 认为 他 是 事故 的 罪魁 祸首 。 
i hope that you will get well soon . 	我 希望 您 快 就 会 好 起来 。 
go get your hel@@ met . 	戴上 你 的 安全 帽 。 
do n't throw trash here . 	别 在 这儿 扔 垃圾 。 
put on your good shoes . 	穿 上 你 的 好 鞋 。 
what do you think i 've been doing ? 	你 觉得 我 之前 在 做 什么 ？ 
i miss you so much . 	我 如此 想念 你 。 
to my surprise , the door was un@@ locked . 	令 我 惊讶 的 是 ， 门没 上锁 。 
this is a very tall tree . 	这 是 棵 很 高 的 树 。 
put the book on the bo@@ t@@ tom shelf . 	把 这本书 放在 架子 的 底部 。 
i love nature . 	我 爱 大自然 。 
do not fear the unexpected , but be prepared for it . 	不要 害怕 意外 ， 但 要 有 准备 。 
he seems to be rich . 	他 看 起来 很 有 钱 。 
i arrived at school on time . 	我 按时 到 了 学校 。 
it is a pity that you can not come to the party . 	很 遗憾 您 不能 来 派对 。 
can you please close that window ? 	请 您 把 那 扇 窗户 关起 来 好 吗 ？ 
she gave away all her dresses . 	她 把 她 所有 的 洋装 都 送 人 。 
i think tom might not want to do that . 	我 认为 汤姆 可能 不想 那样 做 。 
he 's a good guy . 	他 是 个 好人 。 
is breakfast inclu@@ ded ? 	包括 早饭 吗 ？ 
my birthday fa@@ lls on sunday . 	我 的 生日 在 星期日 。 
how far is it from here ? 	离 这儿 有多远 ？ 
both of them are in the room . 	他们 两个 人 都 在 房间里 。 
tom will never see you again . 	汤姆 以后 再也 不会 见 你 了 。 
i asked her to wait a moment . 	我 请 她 等 一会儿 。 
he pretended not to hear me . 	他 假装 没 有 听 见 我 。 
we ca n't afford to make mistakes . 	我们 承担 不了 犯错 的 后 果 。 
tom likes chocolate cake a lot . 	汤姆 很 喜欢 巧克力 蛋糕 。 
could you lend me the book ? 	你 能 借 我 这 本书 吗 ？ 
i 'll be staying here for another three days . 	我会 在 这儿 再待 上 三天 。 
compare your translation with his . 	比较 你 和 他 的 翻译 。 
no one supp@@ or@@ ted his mo@@ tion . 	没人 支持 他 的 动议 。 
stop me@@ dd@@ ling . 	别 再 插手 。 
i want to brush up my english . 	我要 温习 一下 我 的 英文 。 
he slipped me a note . 	他 悄悄地 递给 我 一张 纸条 。 
i did n't get along with her . 	我 没 有 和 她 相处过 。 
he has to repair the clock . 	他 必须 修理 这个 时钟 。 
i 've always tru@@ sted your jud@@ g@@ ment . 	我 一直 都 相信 你 的 判断 。 
about how much will i have to pay for all the treat@@ ments ? 	所有 的 医药费 我 大概 要付 多少 ？ 
i can not follow your logic . 	我 跟不上 你 的 逻辑 。 
the revolution has brought about many changes . 	这场 革命 已经 带来 了 很多 改变 。 
mathematics is my favorite subject . 	数学 是 我 最 喜欢 的 科目 。 
let 's discuss it . 	来 商量 吧 。 
the boy f@@ eared the dark . 	这个 男孩 害怕 黑夜 。 
he is allergic to house dust . 	他 对室 内灰尘 过敏 。 
turn on the radio , please . 	请 打开 收音机 。 
he went to boston by car . 	他 坐 汽车 到 波士顿 。 
i was out of town on vacation . 	我 出城 度假 了 。 
this place still looks the same as it did a long time ago . 	这里 就 像 在 古时候 一样 。 
i want him to play the guitar . 	我要 他弹 吉他 。 
i have a new car . 	我 有 辆 新车 。 
what did you buy ? 	你 买 了 什么 ？ 
you know i have no choice , do n't you ? 	你 知道 我 没法 选择 ， 不是 么 ？ 
this is not a sentence . 	这 不是 一个 句子 。 
japan depends on foreign countries for oil . 	日本 依赖 外国 的 石油 。 
he f@@ ought against ra@@ cial discrimin@@ ation . 	他 反 对 种族 歧视 。 
tom has just returned from the post office . 	汤姆刚 从 邮局 回来 。 
the situation is getting worse and worse day by day . 	情况 一天 比 一天 差 。 
tom , i want to talk to mary . 	汤姆 ， 我 想 跟 玛丽 谈话 。 
you must always tell the truth . 	你 必须 永远 说 实话 。 
we need a hero . 	我们 需要 英雄 。 
my brother likes hor@@ ror movies . 	我 哥哥 喜欢 恐怖 电影 。 
i like swee@@ ts . 	我 喜欢 甜食 。 
we really enjoyed ourselves . 	我们 真的 玩得 很 开心 。 
how heavy is your suitcase ? 	您 的 行李箱 有 多重 ? 
we 'll deal with this problem in cha@@ pter 3 . 	我们 在 第三章 讨论 这个 问题 。 
i 'm afraid i 've off@@ ended you . 	我怕 我 冒犯 了 你 。 
a lot of houses were washed away by the flood . 	许多 房屋 被 洪水 冲走 了 。 
tom is working the night shi@@ ft . 	汤姆上 夜班 。 
do you promise ? 	你 保证 吗 ？ 
i still have n't found work . 	我 还没有 找到 工作 。 
turn on the radio . 	打开 收音机 。 
i do n't go to school by bus . 	我 不 乘 公交 去 学校 。 
you know quite a lot about su@@ m@@ o . 	你 对 相 扑 知道 得 很多 。 
what 's your telephone number ? 	你 电话号码 是 多少 ？ 
he always keeps his room clean . 	他 总 是 把 他 的 房间 保持 干净 。 
are you still collecting stamps ? 	你 还在 收集 邮票 吗 ？ 
his pictures were hung on the wall . 	他 的 画 被 悬挂 在 墙上 。 
he will regret it sooner or later . 	他 迟 早会后悔 。 
you should begin with easier questions . 	你 应该 先 从 最 简单 的 问题 开始 。 
i was born in the winter . 	我 在 冬天 出生 。 
if you need a dictionary , i can lend you my old one . 	如果 你 需要 字典 ， 我 就 把 我 旧 的 借给 你 。 
can i try on this jacket ? 	我 可以 试穿 这件 外套 吗 ？ 
i had a neighbor who was blind . 	我 有 个 盲邻 居 。 
green suits you . 	绿色 适合 你 。 
i put some cream in my coffee . 	我 在 我 的 咖啡 里放 了 一些 奶油 。 
tom does n't understand this . 	汤姆 不 明白 这事 。 
where 's the nearest shopping ma@@ ll ? 	最近 的 大 卖场 在 哪里 ？ 
tom is shy . 	汤姆 害羞 。 
this is the house where she used to live . 	这 是 她 曾经 住 过 的 房子 。 
i think tom 's ch@@ eating . 	我 觉得 汤姆 有 外遇 。 
this could be fun . 	这 可能 很 好玩 。 
could you lend me your bicycle for a couple of days ? 	你 能 把 你 的 自行车 借 我 两天 吗 ？ 
i do n't understand at all . 	我 完全 不 懂 。 
she may come . 	她 可以 来 。 
do you know how to dance ? 	你 会 跳舞 吗 ？ 
would you like to wait ? 	你 愿意 等 吗 ? 
it 's pretty heavy . 	它 真重 。 
do you have a camera ? 	你 有 照相机 吗 ？ 
the plane crash was only last week . 	上个 星期 这架 飞机 坠毁 了 。 
i 'll pick you up at your home . 	我会 去 你家 接 你 。 
your bicycle is similar to mine . 	你 的 脚踏车 和 我 的 很 相似 。 
i called him up yesterday . 	我 昨天 打电话给 他 。 
she kept on working . 	她 继续 工作 。 
wash your feet . 	洗 您 的 脚 。 
he may have been ill . 	他 可能 病 了 。 
i do n't want to go there again . 	我 不想 再次 去 那儿 。 
i ran as fast as possible . 	我 尽 可能 地 跑 快 一点 。 
facts are stu@@ b@@ born things , but sta@@ ti@@ stics are p@@ liable . 	事实 是 倔强 的 ， 但 统计 是 柔顺 的 。 
you and i are good friends . 	你 和 我 是 好 朋友 。 
you ask too many questions . 	你 问题 太多 了 
she gets up at seven . 	她 早上 7 点 起床 。 
there was hardly anyone in the room . 	房间里 几乎 没 有人 。 
tom wondered where mary had learned french . 	汤姆 想 知道 玛丽 在 哪里 学会 了 法语 。 
i do n't have a computer . 	我 没 有 电脑 。 
tom ate half the cake by himself . 	汤姆 独自 吃 了 半个 蛋糕 。 
he walks his dog every morning . 	他 每天 早晨 溜 狗 。 
let me make you some tea . 	让 我给 你 沏茶 。 
i like tennis and golf . 	我 喜欢 打 网球 和 高尔夫球 。 
she 's about the same age as i am . 	她 大约 跟 我 同年 纪 。 
i ca n't b@@ end my right arm . 	我无法 弯曲 我 的 右 手臂 。 
there is a strike . 	有 罢工 。 
you need not do it at once . 	你 没 必要 马上 去 做 。 
she lived a lonely life . 	她 的 生活 很 寂寞 。 
he looked over my report . 	他 仔细 看 了 我 的 报告 。 
i ate bread and butter this morning . 	今天 早上 ， 我 吃 了 面包 夹 黄油 。 
i was sho@@ cked by yesterday 's news . 	昨天 的 消息 让 我 感到 震惊 。 
tom did n't attend the meeting . 	汤姆 没有 参加 会议 。 
we expect a lot from him . 	我们 对 他 期望 很多 。 
she had already gone when i arrived . 	当我到 的 时候 ， 她 已经 走 了 。 
he is still here . 	他 还 在 这儿 。 
i love parties . 	我爱派 对 。 
`` where were you ? '' `` i was at a friend 's house . '' 	“ 你 在 哪里 ？ ” “ 我 在 一个 朋友家 。 ” 
are you lost ? 	您 迷路 了 吗 ？ 
come along with me . 	请 跟 我 来 。 
i can open the window . 	我 可以 打开 这扇 窗 。 
she is more pretty than beautiful . 	说 她 美 不如 说 她 可 爱 。 
do you have a lot of time to relax ? 	你 有 很多 休闲 时间 吗 ？ 
she hit him . 	她 打 了 他 。 
many tv programs have a bad influence on children . 	许多 电视 节目 对 儿童 有 不良 的 影响 。 
it 's no good trying to persu@@ a@@ de her . 	试图 劝 她 是 没 有用 的 。 
tom is good at cooking . 	汤姆 擅长 烹饪 。 
i do n't think tom understands that . 	我 不 认为 汤姆 明白 。 
new year 's day is close at hand . 	元旦 就 在 眼前 。 
you are your own worst enemy . 	你 是 你 自己 最大 的 敌人 。 
he is difficult to get along with . 	他 这个 人 很 难 相处 。 
i do n't mind walking in the rain . 	我 不 介意 在 雨 中 漫步 。 
the baby cried all night . 	这 孩子 哭 了 一 整夜 。 
i expected him to offer some help . 	我 期待 他 提供 一些 帮助 。 
tom promised that he 'd come , but he did n't . 	汤姆答 应 他 会 来 ， 但 他 没来 。 
tom refused to answer any questions . 	汤姆 拒绝 回答 任何 问题 。 
we got there at the same time . 	我们 在 同一 时间 到 了 那里 。 
i do n't like sushi . 	我 不 喜欢 寿司 。 
she took full advantage of her stay in london to improve her english . 	她 充分 利用 她 住 在 伦敦 的 优势 ， 提高 英语 。 
watch out for thi@@ e@@ ves around here . 	在 这 附近 当心 小偷 。 
my shoes are bigger than yours . 	我 的 鞋 比 你 的 大 。 
my father is swee@@ ping the garage . 	我 父亲 正在 清扫 车库 。 
refu@@ ge@@ es poured in from all over the country . 	难民 从 整个 国家 涌来 。 
the fox and the bear lived together . 	这 只 狐狸 和 这 只 熊 一起 生活 了 。 
let them take care of themselves . 	让 他们 照顾 自己 。 
i 'm sorry , could you say that again ? 	抱歉 ， 你 能 再说 一遍 吗 ？ 
he is as tall as his father . 	他 和 他 爸爸 一样 高 。 
this is a comfortable chair . 	这 是 张 舒服 的 椅子 。 
put your hands up ! 	把手 举 起来 ！ 
my sleep was distur@@ bed by the sound . 	那 声音 搅 了 我 的 美梦 。 
the girl was afraid to jump down from the roof . 	小女孩 害怕 从 屋顶 上 跳 下来 。 
would you let me know when tom comes ? 	你 能 让 我 知道 汤姆 什么 时候 来 吗 ？ 
i do n't like tea . 	我 不 喜欢 喝茶 。 
she made tea for me . 	她 给 我 沏 了 茶 。 
he lost his eyesight in an accident . 	他 在 一次 意外 中 失去 了 他 的 视力 。 
remember to mail this letter tomorrow morning . 	明天 早上 记得 去 寄 这 封信 。 
tom is a violin teacher . 	汤姆 是 小提琴 教师 。 
you should get your hair cut . 	你 该 理发 了 。 
where is your dog ? 	你 的 狗 在 哪儿 ？ 
what shall we eat for breakfast ? 	我们 早饭 吃 什么 ？ 
i like to travel by train . 	我 喜欢 搭 火车 旅行 。 
she got a new cd player yesterday . 	她 昨天 得到 了 一个 新 的 CD 播放 机 。 
i 'll drop by the post office on the way home . 	我会 在 回家 的 路上 顺便 去 邮局 。 
tom certainly is an interesting person . 	汤姆 这人 确实 很 有意思 。 
i 'm closing the door . 	我 在 关门 。 
i talked with tom . 	我 和 汤姆 说 了 话 。 
are you busy now ? 	现在 你 们 忙 吗 ？ 
i 'm bad at sports . 	我 不 擅长 运动 。 
i could n't remember their names . 	我 不 记得 他们 的 名字 了 。 
very few people live to be 100 . 	很少 人活 到 100 岁 。 
she walks . 	她 在 行走 。 
i do n't think tom understands what 's going on . 	我 不 认为 汤姆 知道 正在 发生 甚么 。 
i arrived at the station on time . 	我准 时 到 达 了 车站 。 
he is very sensitive . 	他 很 敏感 。 
tom and mary both know who you are . 	汤姆 和 玛丽 都 知道 你 是 谁 。 
december has thir@@ ty-one days . 	十二月 有 三十 一天 。 
it is difficult to understand his theory . 	他 的 理论 很 难懂 。 
it seems obvious that he is sick . 	似乎 很明显 他 病 了 。 
you have a wonderful voice . 	你 有 副 好 嗓音 。 
when did you start working here ? 	从 什么 时候 开始 您 就 这里 工作 着 的 呢 ？ 
i could smell the alcohol on his breath . 	我能 闻到 他 呼吸 中 的 酒精 味 。 
i have n't seen you in ages . 	我 已经 好久 没有 见 到 你 了 。 
this story is true . 	这个 故事 是 真的 。 
he sat on the bench . 	他 坐在 长 凳 上 。 
in the summer i wear shor@@ t-@@ slee@@ ved shir@@ ts . 	夏天 我 穿 短袖 衬衫 。 
let us know when you 'll arrive . 	让 我们 知道 你 什么 时候 会 到 。 
i could n't understand his ideas . 	我无法 理解 他 的 想法 。 
she kept me waiting for 30 minutes . 	她 让 我 等 了 30 分钟 。 
he pa@@ used to have a cigarette . 	他 停 下来 抽根烟 。 
he 's been to the stadium . 	他 去 过体育馆 。 
please go to the bank . 	请 去 银行 。 
i ca n't believe your parents let you come here by yourself . 	我 不敢 相信 你 父母 让 你 自己 过来 。 
one of the children left the door open . 	其中 一个 孩子 让门 开著 。 
i do n't know if tom can help us . 	我 不 知道 汤姆能 不能 幚 我 们 。 
a bookstore in that location would n't make enough money to survive . 	那个 地点 的 书店 无法 赚 足够 的 钱 生存 下去 。 
nobody knows why he turns down my help . 	没 有人 知道 他 为何 拒绝 我 帮忙 。 
he told me that he was busy then . 	他 告诉 我 他 那时 很忙 。 
this desk is de@@ signed for children . 	这张 书桌 是 专门 为 儿童 设计 的 。 
can you tell me how to get to the train station ? 	你 可以 告诉 我 如何 到 火车 站 吗 ? 
this room is cleaned by tom . 	这房间 是 由 汤姆清 扫 的 。 
do you know the boy in the picture ? 	你 认识 画 里面 的 男孩 吗 ？ 
she devoted her life to working among the poor . 	她 一生 致力 于 为 穷人 工作 。 
you can lie to everyone else , but you ca n't lie to yourself . 	你 可以 向 别人 撒谎 ， 但 你 不会 向 自己 撒谎 。 
london is famous for its fog . 	伦敦 以雾 著名 。 
do n't talk in the classroom . 	别 在 教室 里说 话 。 
why are you asking me ? 	你 为 什么问 我 ？ 
he 's very fond of science fiction . 	他 非常 喜欢 科幻 小说 。 
he came back last au@@ gust . 	他 去年 八月 回来 的 。 
maybe they have something . 	他们 可能 有点 什么 。 
i really do n't know that woman . 	我 完全 不 认识 那个 女人 。 
it 's not mine . 	不是 我 的 。 
let us know whether you can come . 	让 我们 知道 你 是否 能来 。 
i 've had just about enough of her . 	我 真的 受够 了 她 。 
how do you get your children to eat vegetables ? 	你 怎样 让 你 的 孩子 们 吃 蔬菜 ？ 
his ob@@ serva@@ tions are sharp , but he does n't say much . 	他 的 观察是 敏锐 的 ， 但 他 没 有 说 太 多 。 
not a single person arrived late . 	没有 一个 人 迟到 。 
he usually goes to school by bus . 	他 经常 搭公车 上学 。 
we had a hear@@ t-@@ to@@ -@@ heart talk with each other . 	我们 促膝谈心 。 
why do you ask ? 	你问 这个 干什么 ? 
it is true that she is pretty , but she is sel@@ fish . 	她 确实 很 漂亮 ， 但 她 很 自私 。 
the police are after him . 	警察 在 跟 著 他 。 
what do you think about this plan ? 	你 觉得 这个 计划 怎么样 ？ 
she seemed to have been ill . 	好像 她 病 了 。 
i was almost hit by a car . 	我 几乎 被 车撞 到 了 。 
you can dele@@ te that now . 	你 现在 可以 删除 它 。 
if you eat that much , you 'll have a stomachache . 	那么 吃 的话 ， 肚子 会 吃 坏 的 噢 。 
is there a service charge for that ? 	要 收服 务费 吗 ? 
i hope that mary pas@@ ses the examination . 	我 希望 玛丽 通过 考试 。 
he did n't know that . 	他 不 知道 。 
my father has been engaged in foreign tra@@ de for many years . 	我 父亲 经营 外贸 多年 。 
the boy is playing with his toy soldiers . 	男孩 在 玩 玩具 兵 。 
my father is suffering from a cold . 	我 父亲 感冒 了 。 
he knows how to swim . 	他会 游泳 。 
i 'm going to go tell tom . 	我要 告诉 汤姆 。 
look at that smoke . 	快 看 那个 烟 。 
i had a telephone call from her . 	她 打 了 一通 电话给 我 。 
i en@@ coun@@ ter@@ ed a problem . 	我 遇到 了 故障 。 
he comes here almost every day . 	他 几乎 每天 都 来 。 
she got wet to the skin . 	她 浑身 湿透 了 。 
he 'll be back home soon . 	他 很快 就 会 回家 。 
this is a bird san@@ c@@ tu@@ ary . 	这是 鸟类 庇护 所 。 
tom is at school , is n't he ? 	汤姆 在 学校里 ， 不是 么 ？ 
she seems to hate you . 	她 好像 很 讨厌 你 。 
may i ask you some more questions ? 	我 可以 问你 一些 问题 吗 ？ 
let me buy you another one . 	我 给 你 再 买 一个 吧 。 
i 'd like to check out right now . 	我想现 在 结帐 离开 。 
is it poi@@ son@@ ous ? 	它 有毒 吗 ？ 
he enjo@@ ys watching baseball games on tv . 	他 喜欢 看 电视 上 的 棒球 比赛 。 
your composition has a few mistakes . 	你 的 作文 有 一些 错误 。 
no students were absent . 	没有 学生 缺席 。 
who told you that tom and i are dating ? 	谁 告诉 你 我 和 汤姆 在 交往 的 ？ 
i do n't like going to school . 	我 不 喜欢 上学 。 
this is surpri@@ sing . 	这是 令人 吃 惊 的 。 
it 's great . 	真是 太好 了 。 
things are totally different now . 	现在 全都 不一样 了 。 
this letter is ad@@ dressed to you . 	这 封信 是 寄给 你 。 
this stone is too heavy to lift . 	这块 石头 太重 了 无法 擡起 来 。 
why do you want to be a nurse ? 	你 为什么 想 成为 护士 呢 ？ 
you 've worked hard for months and have certainly earned a holiday . 	你 已经 辛苦 地 工作 好 几个 月 了 , 当然 可以 休假 。 
more often than not , she had to go in person . 	很多 时候 她 要 亲自去 。 
we talked over the plan with him . 	我们 和 他 谈 了 这个 计划 。 
tom is n't as innocent as he seems . 	汤姆 不像 他 看上去 的 那样 无辜 。 
i knew you 'd find tom . 	我 知道 你 会 找到 汤姆 。 
is this the bus for park ri@@ dge ? 	这是 去 帕克 里奇 的 巴士 ？ 
he is driving at top speed . 	他 全速 驾驶 着 。 
how about going to see a movie tonight ? 	今晚 看 电影 怎么样 ？ 
he 's eating an apple . 	他 正 吃 著 一个 苹果 。 
he did n't hear his name called . 	他 没 听见 有人 叫 他 的 名字 。 
tom can swim almost as fast as i can . 	汤姆 几乎 能游 得 跟 我 一样 快 。 
it 's hard to quit smoking . 	戒烟 难 。 
i feel like taking a bath now . 	我现 在 想 洗澡 。 
by the way , my english is absolutely hopeless . 	顺道 一提 ， 我 的 英语 是 绝对 没有 希望 了 。 
he thought of a good solution . 	他 想到 了 一个 解决 的 好 办法 。 
this is the end . 	这是 结束 。 
tom is a very talented writer . 	汤姆 是 个 很 有 才华 的 作家 。 
let me ask a stupid question . 	我来 问个 有点 傻 的 问题 。 
keep oil away from the fire . 	让 油远 离火 。 
do you think you could make a little less noise ? 	你 觉得 你 能少 发点 噪音 吗 ？ 
eighty percent of all information on computers around the world is in english . 	全世界 百分之八十 电脑 上 的 资讯 都 是 用 英语 写 的 。 
here 's how we do it . 	以下 是 我们 怎么 做 的 。 
app@@ ar@@ ently , there is nothing that can not happen today . 	显然 ， 今天 什么 事 都 有 可能 发生 。 
lincoln was elected president in 18@@ 6@@ 0 . 	林肯 在 1860 年 当选为 美国 总统 。 
i lost my camera the other day . 	那天 我 丢 了 我 的 照相机 。 
i could n't answer all the questions . 	我 无法 回答 所有 问题 。 
i like being on the team . 	我 喜欢 在 队伍 里 。 
he is afraid of his own sha@@ dow . 	他怕 自己 的 影子 。 
did you know that before ? 	你 之前 知道 那个 吗 ？ 
i 'd like the sauce on the side . 	我 想要 酱料 放在 旁边 。 
she wore a red dress . 	她 穿 了 一条 红色 的 裙子 。 
mary closed the door quietly . 	玛丽 悄悄地 关上 了门 。 
she is walking . 	她 在 行走 。 
i want to be as tall as tom . 	我 想 和 Tom 一样 高 。 
he had his head in the clouds in class . 	他 在 课 堂上 心不在焉 。 
just relax . 	放松 点 吧 。 
what 's your opinion on that ? 	关于 那个 你 有 什么 看法 ？ 
tom studies at harvard . 	汤姆 在 哈佛 学习 。 
i have to go to sleep . 	我 该 去 睡觉 了 。 
i am a japanese high school girl . 	我 是 一个 日本 的 高中 女生 。 
i ca n't get at the exact meaning of the sentence . 	我 抓 不到 句子 的 确切 含义 。 
i 'm sorry , but i really have to go . 	我 很 抱歉 ， 但 我 必须 走 了 。 
take it easy . 	别紧 张 。 
i 'm in@@ cre@@ di@@ bly tired . 	我 累死 了 。 
she 's very beautiful . 	她 非常 漂亮 。 
can i go swimming this afternoon ? 	我 今天 下午 可以 去 游泳 吗 ？ 
actions speak louder than words . 	行动胜 于 雄辩 。 
he went to america to study medicine . 	他 去 美国 学医 了 。 
do n't forget to lock up when you leave . 	当 你 出门 时 ， 别 忘 了 锁门 。 
she was coming down the stairs . 	她 下楼 。 
you ca n't do two things at once . 	你 不能 一心 两用 。 
she says he will not give up smoking . 	她 说 他 不会 戒烟 。 
i ca n't concentrate on my work because of the noise . 	由于 噪音 ， 我 无法 集中 精力 工作 了 。 
why do you want to kill me ? 	你们 为 什么 想 杀 我 ？ 
it is easy to swim . 	游泳 很 简单 。 
it must be done more carefully . 	应该 更 谨慎 地 处理 它 。 
i hope i will have a chance to see you next time i 'm in new york . 	希望 下次 我 在 纽约 还 可以 有 机会 见到 你 。 
tell tom i 'll be there in a minute . 	告诉 Tom 我 将 在 一分钟 内 到达 这里 。 
he came at three in the afternoon . 	他 在 下午 三点钟 的 时候 来 了 。 
do you have it ? 	你们 有 吗 ? 
he does not like being punished . 	他 不 喜欢 被 惩罚 。 
i 'm not sure tom would help . 	我 不 确定 汤姆能 不能 帮忙 。 
winter is just around the corner . 	冬季 快来 了 。 
someone is watching . 	有人 在 监视 。 
i have just finished my homework . 	我 刚刚 完成 我 的 作业 。 
liars must have a good memory . 	骗子 们 必须 有 好 记性 。 
please speak slowly . 	请 说 慢 一些 。 
she 's still dependent on her parents . 	她 现在 依然 依靠 父母 生活 。 
tom knows him . 	汤姆 认识 他 。 
she wants a new dress badly . 	她 很 想要 一条 新 的 连衣裙 。 
this is kind of interesting . 	这 真是 有趣 。 
his explanation is not clear . 	他 的 说 明并 不 清楚 。 
how can i reach you ? 	我 怎么 联系 你 ？ 
i gave careful consideration to the problem . 	我 仔细地 考虑 了 这个 问题 。 
he studied abroad . 	他 出国 留学 了 。 
only ad@@ ults may watch that film . 	只有 成人 可以 看 那种 电影 。 
do we know you ? 	我们 认识 你 么 ？ 
yes , of course . 	是 的 ， 当然 。 
you are wanted on the phone . 	有 你 的 电话 。 
call an ambu@@ lance . 	叫 救护车 。 
how was the food ? 	食物 怎么样 ？ 
that student runs fast , does n't he ? 	那个 学生 跑 得 很快 ， 不是 吗 ？ 
he accepted my idea . 	他 接受 了 我 的 主意 。 
tom was hit by a truck and died in@@ stantly . 	汤姆 被 卡车 撞 到 而且 当场 死亡 。 
he gave the same answer as before . 	他给 了 跟 以前 一样 的 回答 。 
the boy went to bed with his socks on . 	男孩 穿着 袜子 就 上床 睡觉 了 。 
the two of us do n't belong here . 	我们 俩 不 属于 这儿 。 
he att@@ ri@@ bu@@ tes his success to good luck . 	他 将 他 的 成功 归功 于 好运 。 
take things a little more seriously . 	对 事情 比较 正经 严肃 。 
you 're im@@ patient . 	你 缺乏 耐心 。 
it ser@@ ves you right . 	自作自受 。 
have you eaten your lunch yet ? 	你 吃 过午 饭 了 吗 ？ 
the letter was finished . 	信写 完 了 。 
i 'm very worried about my weight . 	我 很 担心 我 的 体重 。 
would you pass me the salt , please ? 	请 你 把 盐 递给 我 好 吗 ? 
you 're very smart . 	你 很 聪明 。 
it is not always cold in hokkaido . 	北海道 并不总是 寒冷 。 
christmas is soon , right ? 	圣诞节 很快 就 到 了 ， 对 吗 ？ 
i have only five thousand yen . 	我 只有 5000 日元 。 
put your hat on . 	戴上 你 的 帽子 。 
i have a bath every day . 	我 每天 洗 一次 澡 。 
my grandfather is fond of taking a walk early in the morning . 	我 的 爷爷 喜欢 大清早 的 散步 。 
bring the key . 	带 钥匙 来 。 
can you drive a manu@@ al tran@@ smi@@ ssion ? 	你会 开手 排车 吗 ? 
in case of an emergency , get in touch with my ag@@ ent . 	万一 有 紧急 情况 ， 联系 我 的 代理人 。 
it goes without saying that health is important . 	不用说 ， 健康 是 重要 的 。 
please do n't say that . 	请 你 不要 说 这个 。 
he was late because of the snow . 	他 因为 下雪 所以 迟到 了 。 
i do n't like eggs . 	我 不 喜欢 鸡蛋 。 
i spent last sunday reading a novel . 	我 上 周日花 时间 看 了 一本 小说 。 
my son is engaged to his secretary . 	我 的 儿子 和 他 的 秘书订 婚 了 。 
i 'll leave this work to you . 	我会 把 这个 工作 留给 你 。 
do you subscribe to any magazines ? 	你 有 订阅 任何 杂志 吗 ？ 
can you play the piano ? 	你会弹 钢琴 吗 ？ 
how much is the commi@@ ssion ? 	手续费 是 多少 ？ 
do n't listen to her . 	别 听 她 的 。 
what was that you just said ? 	你 刚 说 了 什么 ？ 
it is easy to read this book . 	读 这 本书 很 容易 。 
i ca n't stand this pain any more . 	我 不能 再 忍受 这种 痛苦 了 。 
tom had never lied to me before . 	汤姆 以前 从 不 向 我 说 谎 。 
i was very tired last night . 	我 昨晚 很累 了 。 
sir , can we quickly in@@ spect your luggage please ? 	先生 ， 我们 可以 检查 一下 您 的 行李 吗 ？ 
he may be able to come tomorrow . 	他 也许 明天 能来 。 
air is to us what water is to fish . 	空气 对人 来说 就是 水对 鱼 的 意义 。 
how did you get out of your room ? 	你 怎么 从 你 的 房间 里 出来 ？ 
she made a mess of the work . 	她 把 工作 弄 得 一团 糟 。 
the huge explosion killed six people . 	大 爆炸 致死 六人 。 
if you 're not listening to the radio , turn it off . 	要是 你 不 在 听 广播 的话 ， 就 关掉 它 。 
i do n't think he 'll say yes . 	我 不 认为 他 会 说 好 。 
time wai@@ ts for no one . 	时间 不 等 人 。 
he sha@@ ves every day . 	他 每天 刮 胡 子 。 
we were n't able to find tom . 	我们 找 不到 汤姆 。 
the sky turned dark . 	天暗 了 下来 。 
we 're almost broke . 	我们 快 破产 了 。 
you did n't tell me mary was so beautiful . 	你 没 告诉 我 玛丽 这么 漂亮 。 
that 's what tom promised . 	那 是 汤姆 承诺 的 。 
ladies and gentle@@ men , due to an accident at the airport , our arri@@ val will be delayed . 	女士 们 ， 先生 们 ， 由于 机场 的 意外 情况 ， 我们 的 着陆 将 被 推迟 。 
i want to go for a swim . 	我 想 去 游泳 。 
it is too late . 	太晚 了 。 
this is my business address . 	这 是 我 的 公司 地址 。 
our new home has an elevator . 	我们 的 新家 有 一 台 电梯 。 
i should do it . 	我 应该 去 做 。 
we owe you an apology . 	我们 欠 你 个 道歉 。 
this is n't a good idea . 	这 不是 好 主意 。 
i want to get rid of it . 	我想 摆脱 它 。 
have fun . 	玩得 开心 。 
let 's take it easy . 	让 我们 放 轻 松 吧 。 
my uncle never writes letters . 	我 的 叔叔 从来 不 写 信 。 
he has been to hokkaido . 	他 曾 去过 北海道 。 
i ca n't go . 	我 不能 走 。 
he threw a stone at the big dog . 	他 朝着 大狗 扔 了 块 石头 。 
he was born on july 2@@ 8@@ th , 18@@ 88 . 	他 出生 于 1888 年 7 月 28 日 。 
i 'm stuck in my job . 	我 被 工作 困住 了 。 
he threw a rock into the pond . 	他 扔 一块 石头 到 池塘 里 。 
some people like summer , and others like winter . 	有人 喜欢 夏天 ， 有人 喜欢 冬天 。 
she is always dressed in black . 	她 总 是 一身 黑 。 
did you find anything interesting ? 	你 找到 有趣 的 东西 了 吗 ？ 
i asked him to wait here . 	我 请 他 在 这里 等 。 
turn left at the first light . 	在 第一 个 红绿灯 左转 。 
i 'm young . 	我 还年 轻 。 
the lid wo n't open . 	这盖子 打不开 。 
what 'll you be doing at this time tomorrow ? 	你 明天 这个 时候 会 是 在 做 什么 ？ 
you should n't go out . 	你 不 应该 出去 。 
do you think animals have a soul ? 	你 认为 动物 有 灵魂 吗 ？ 
our child likes dogs , but i prefer cats . 	我们 的 孩子 喜欢 狗 ， 但 我 更 喜欢 猫 。 
i walked as far as the station . 	我们 走 到 跟 火车 站 那样 远 的 地方 。 
i know that you are busy . 	我 知道 您 们 也 很 忙碌 。 
my father has been to australia twice . 	我 父亲 曾 经去过 澳洲 两次 。 
i like to do my homework . 	我 喜欢 做 我 的 作业 。 
the room origin@@ ally had no furniture . 	本来 这间 房间 里 没有 家具 。 
i got on the wrong train . 	我 上 错 了 火车 。 
brush your teeth before going to bed . 	上床 睡觉 前要 刷牙 。 
there is a cat under the desk . 	书桌 下有 一只 猫 。 
there are several ways to mea@@ sure speed . 	测速 的 方法 有 很多 。 
when was tom fired ? 	汤姆什么 时候 被 开除 的 ? 
i could n't agree with you more . 	我 非常 同意 你 。 
we hope you will enjoy the show . 	我们 希望 你 喜欢 这个 表演 。 
that was the first time that a man walked on the moon . 	那 是 人类 第一次 在 月球 上 行走 。 
is one thousand yen enough ? 	1000 日元 够 不够 ？ 
i 've never seen him wearing jeans . 	我 从 来 没 有 看过 他 穿 牛仔 裤 。 
i like these . 	我 喜欢 这些 。 
i was absent from the party . 	我 没 去 派 对 。 
why do you need to read such a book ? 	为什么 你 要 读 这样 一 本书 ？ 
i have a certain amount of money on me . 	我 有些 钱 。 
his wife is in the hospital because she was injured in a car crash . 	他 的 妻子 在 医院里 因为 她 在 一场 车祸 中 受伤 了 。 
i am studying now . 	我 现在 正在 学习 。 
her father passed away last week . 	她 的 父亲 上 周 去世 了 。 
school will start next monday . 	下周一 开学 。 
it makes no difference to me . 	这对 我 没什么 差别 。 
i think i may have made a big mistake . 	我 认为 我 可能 已经犯 了 大错 。 
tom wanted to see mary 's room . 	汤姆想 看看 玛丽 的 房间 。 
i 'm glad to hear that . 	我 很 高兴 听 到 这个 消息 。 
may i borrow your car ? 	我 可以 借用 你 的 车吗 ？ 
there was a big earthquake last night . 	昨晚 有 一场 大 地震 。 
is it far ? 	远 吗 ？ 
tom thanked mary for coming . 	汤姆 感谢 玛丽 的 光临 。 
the experiment was successful . 	这实验 是 成功 的 。 
even though she grew up in japan , she speaks fluent english . 	尽 管 她 在 日本 长 大 ， 她 说 一口 流利 的 英语 。 
are you afraid of bu@@ gs ? 	你 怕 虫子 吗 ？ 
what 're you after ? 	你 想要 什么 ? 
may i see your driver 's license ? 	我 可以 看看 你 的 驾驶 执照 吗 ？ 
he has n't come yet . 	他 还没来 。 
this knife is very sharp . 	这 把 刀 很 锋利 。 
tom says he 's very rich . 	汤姆 说 他 很 有 钱 。 
my father took out his wallet and gave me ten dollars . 	我 爸爸 拿出 他 的 钱包 ， 并 给 了 我 10 美元 。 
she st@@ ab@@ bed him in the back . 	她 在 他 的 背上 戳 了 一下 。 
none of these buses go to shinjuku . 	这些 巴士 中 没 有 一辆 去 新宿 。 
please tell me when to go . 	请 告诉 我 什么 时候 该 走 。 
we 'd better wake tom up . 	我们 最好 叫醒 汤姆 。 
those houses are 5@@ 00 years old . 	那些 房子 有 500 年 了 。 
i want an mp@@ 3 player ! 	我 想要 一个 MP3 播放器 ！ 
tom knows the difference . 	汤姆 知道 不同 之处 。 
the vacation is over now . 	现在 假期 结束 了 。 
i always study hard . 	我 总 是 用功 读书 。 
i have to give back the book before saturday . 	我 必须 在 礼拜六 之前 把 书 还 回去 。 
i owe him 1@@ ,000 dollars . 	我 欠 他 1000 美元 。 
it 's already time to go home . 	已经 是 时候 回去 了 。 
he was mad because he was not invited . 	他 因为 没有 被 邀请 而气 得 快 疯 了 。 
i know you 're rich@@ er than me . 	我 知道 你 比 我 有 钱 。 
he made his son a weal@@ thy man . 	他 使 他 儿子 成 了 个 有钱人 。 
i heard our dog bar@@ king all night . 	我 听 到 我们 的 狗 叫 了 一 整夜 。 
please give me something hot to drink . 	请给 我 一些 热的 东西 喝 。 
tom said he keeps a gun in his home . 	汤姆 说 他 的 家里 有 把 枪 。 
here , catch ! 	这里 ， 快 抓住 。 
may i go out to play ? 	我 可以 出去 玩 吗 ？ 
did you get the package i sent you ? 	你 收到 我寄给 你 的 包裹 了 吗 ？ 
i 'd like to try this on . where are the fi@@ tting rooms ? 	我 想 试试 这件 。 请问 哪里 是 试衣间 ？ 
i felt like crying . 	我 想 哭 。 
maybe you 'd better come with us . 	也许 你 最好 和 我们 一起 来 。 
let 's go ! 	走 吧 。 
tell me what to do with it . 	告诉 我 拿 它 做 什么 。 
i helped her wash dishes . 	我 帮 她 洗碗 。 
do you have a tv ? 	你 有 电视 吗 ？ 
you 're just a coward . 	你 就是 胆小鬼 。 
we want to be on the first bus tomorrow morning . 	我们 想 乘 明天 早上 第一 班 公交车 。 
i do n't feel comfortable here . 	我 在 这里 感到 不 舒服 。 
i asked a policeman for directions . 	我 向 一个 警察 问路 。 
let 's go out and eat dinner together from time to time . 	让 我们 偶尔 出去 一起 吃 晚餐 。 
he lost a fortune in the stock market . 	他 玩 股票 赔 了 。 
he is rather hard to please . 	取悦 他 很 难 。 
he lives alone . 	他 独自 生活 。 
please allow me to go . 	请 允许 我 去 。 
i saw him wash the car . 	我 看 见 他 洗车 。 
that 's great . 	那 真是 太好 了 。 
he ca@@ tches colds easily . 	他 很 容易 感冒 。 
which of these ra@@ ckets is yours ? 	这些 球拍 中 哪 一支 是 你 的 ？ 
what 's tom so angry about ? 	汤姆为 了 甚么 生气 ？ 
i 'm your part@@ ner . 	我 是 你 的 伙伴 。 
you can tell us . 	你 能 告诉 我们 。 
i 'll see you whenever it suits you . 	只要 你 方便 ， 我什么 时候 都 可以 跟 你 见面 。 
tom was wearing a bul@@ le@@ t@@ proof v@@ est , so the bul@@ let did n't kill him . 	汤姆 穿 著 一件 防弹 衣 ， 所以 子弹 没 把 他 杀 死 。 
my sister and i went to the castle . 	我 和 妹妹 去 了 城堡 。 
you are not a doctor . 	您 不是 医生 。 
could you please not smoke in this room ? 	请问 你 能 不 在 房间 里 吸烟 吗 ？ 
where do you attend high school ? 	你 在 哪里 念 高中 ? 
fire is always dangerous . 	火总是 危险 的 。 
i think we should try it . 	我 认为 我们 该 试试 。 
that red dress looks good on her . 	她 穿 那件 红色 的 衣服 很 好看 。 
i 'm exhausted . 	困死 了 。 
tom is taller than i am . 	汤姆比 我 高 。 
he does n't have to go to school . 	他 不必 上学 。 
tell us more . 	告诉 我们 多 一点 。 
for the other 6@@ 00 million people , english is either a second language or a foreign language . 	对 于 其他 的 六 亿 人口 而言 ， 英语 不是 第二 语言 就是 外语 。 
when i was a child , i used to swim in that pond . 	当 我 还是 个 孩子 的 时候 ， 我 在 这个 泳池 里游 过泳 。 
he showed me the manu@@ scri@@ pt of his new play . 	他 给 我 看 了 他 最新 剧 的 底稿 。 
i 'll never tell anyone where i 've hi@@ d@@ den the trea@@ sure . 	我 不会 告诉 任何人 我 藏宝 的 地方 。 
i know someone who might be able to help . 	我 知道 有个 人 可能 能 帮忙 。 
can she en@@ dur@@ e a long trip ? 	她 能 忍受 长 途 旅行 吗 ？ 
this juice tastes sour . 	这个 果汁 喝起 来 酸酸的 。 
mary showed the letter to me . 	玛丽给 我 看 了 这 封信 。 
i 'm almost finished reading this book . 	我 就要 读完 这 本书 了 。 
are n't you tom ? 	你 不是 汤姆 吗 ? 
she usually gets up early . 	她 通常 很早 起床 。 
he kept his promise . 	他 信守 了 他 的 承诺 。 
could you teach me how to play the piano ? 	您 能教 我弹 钢琴 吗 ？ 
tom went into the kitchen and poured himself a cup of coffee . 	汤姆 进 了 厨房 ， 给 自己 倒 了 杯 咖啡 。 
he always tells the truth . 	他 总 是 说 实话 。 
i 'll tell tom you said that . 	我会 告诉 汤姆 你 说 了 那话 。 
tom showed up just in time . 	汤姆 刚好 准时 到 了 。 
let me think . 	让 我 想 一想 。 
i have brothers . 	我 有 兄弟 。 
he is likely to win the game . 	他 有 可能 赢得 比赛 。 
close the door . 	关门 。 
do n't do anything like that again . 	不要 再 做 那样 的 事情 了 。 
this is a good place to pi@@ tch a tent . 	这 是 搭 帐篷 的 好 地方 。 
what 's the weather like today ? 	今天 天气 怎么样 ？ 
my friends invited me to dinner . 	我 的 朋友 邀请 我 去 吃 晚饭 。 
it 's not a cat . it 's a dog . 	它 不是 猫 。 它 是 狗 。 
she thought of a good solution . 	她 想到 了 一个 好 的 解决办法 。 
could you come and see me tomorrow ? 	你 明天 可以 来 看 我 吗 ？ 
he walked in the park yesterday . 	他 昨天 在 公园里 散步 。 
can you skate ? 	你 会 溜冰 吗 ？ 
i do n't fear death . 	我 不怕死 。 
there is an apple on the desk . 	书桌 上 有 一个 苹果 。 
wonderful ! 	很棒 ！ 
tom heard this and got angry . 	听到 这事 之 后 ， 汤姆为 之色变 。 
tom has n't talked to mary in years . 	汤姆 多年 没有 和 玛丽 说话 了 。 
i ca n't believe tom just did that . 	我 不敢 相信 汤姆 那么 做 了 。 
she made cookies for the children . 	她 给 孩子 们 做 了 曲奇 。 
thank you for coming to meet me . 	谢谢 你 来 跟 我 见面 。 
children really like playing on the beach . 	孩子 们 非常 喜欢 在 海滩 上 玩耍 。 
he keeps his room clean . 	他 保持 他 的 房间 干净 。 
they say that old house is haunted . 	据 说 老房子 闹 鬼 。 
the bar@@ o@@ me@@ ter is fa@@ lling . it is going to rain . 	气压计 下降 了 - 要 下雨 了 。 
you ca n't park around here . 	你 不能 在 这 附近 停车 。 
this time , it 's different . 	这次 不 一样 。 
do not leave the lights on when you leave the room . 	离开 房间 时 ， 不要 留灯 。 
the moonlight is really beautiful . 	月光 真美 。 
where are my books ? 	我 的 书 在 哪 ？ 
he is not from hokkaido . 	他 不是 来 自 北海道 。 
let 's take a rest . 	我们 休息 一下 吧 。 
are you hiding something ? 	你 是不是 瞒 着 我 什么 ？ 
we had a good conversation . 	我们 谈得 不错 。 
how long will we have to wait ? 	我们 要 等 多久 ？ 
he quickly went out of the room . 	他 很快 地 走出 了 房间 。 
i agreed with him on the plan . 	对 于 这个 计划 我 同意 他 的 意见 。 
tom refused to help mary do her homework . 	汤姆拒 绝 帮玛丽 做 她 的 作业 。 
i 'm starting to dislike her . 	我 开始 不 喜欢 她 了 。 
i do n't like to go out when it 's dark . 	我 天黑 后 不 喜欢 出门 。 
how soon can we leave ? 	我们 过 多久 才能 离开 ？ 
who invented that ? 	那 是 谁 发明 的 ？ 
there 's no one in your bedroom . 	你 的 卧室 里 没有 人 。 
she quit smoking . 	她 停下 来 抽烟 。 
the teacher demon@@ strated the idea with an experiment . 	这位 老师 用 试验 论证 了 这个 想法 。 
thanks for your reply . 	谢谢 你 的 答复 。 
i got on the train for london . 	我 登上 去 伦敦 的 火车 。 
if it had not been for your help , i could n't have comple@@ ted the work . 	如果 不是 因为 有 你 的 帮助 ， 我 不 可能 完成 了 这个 工作 。 
i am the fastest run@@ ner . 	我 是 最快 的 跑 者 。 
i asked him to open the window . 	我 请 他 把 窗户 打开 。 
i do n't like to leave things up in the air . 	我 不 喜欢 让 事情 悬而 未决 。 
we still have plenty of time left . 	我们还 剩下 很多 时间 。 
is your homework finished ? 	你 的 作业 做 完 了 吗 ？ 
sometimes things that happen do not make sense . 	有时候 ， 发生 的 事情 并 不是 合情合理 的 。 
there was n't a soul in sight . 	一个 人影 也 看不到 。 
i 've got something you 've got to see . 	我 有 个 东西 您 该 看看 。 
tom built his own motorcycle . 	汤姆造 了 他 自己 的 摩托 车 。 
it is me that is wrong . 	是 我 错 了 。 
that is mine . i do n't know where yours is . 	那个 是 我 的 。 我 不 知道 你 的 在 哪里 。 
please speak more loudly . 	请 说 大声 一点儿 。 
her only pleasure is listening to music . 	她 唯一 的 乐趣 就是 听音乐 。 
i 'm getting ready for the worst . 	我 已经 做好 了 最坏 的 打算 。 
big fish eat little fish . 	大鱼吃小鱼 。 
i have a frog in my throat . 	我 的 喉咙 里有 一 只 青蛙 。 
tom dea@@ lt the cards . 	Tom 处理 了 卡片 。 
please say hello to your family . 	带 我 向 你家 人 问好 。 
the bus stop is across the street . 	公车 站牌 就 在 街 对面 。 
i ca n't blame tom for not waiting . 	我 不能 怪 汤姆 不 等 著 。 
is there any mail for me today ? 	今天 有给 我 的 邮件 吗 ？ 
spring will come soon . 	春天 就要 来 了 。 
they both want a child . 	他 俩 想要 一个 孩子 。 
what have i ever done to tom ? 	我 对 汤姆 做 了 什么 ？ 
i need it a@@ sa@@ p . 	我 尽快 需要 。 
he is old enough to know better . 	他 已 经长 大该 懂事 了 。 
may i be excu@@ sed from tomorrow 's class ? 	明天 的 课 我 能 不来 吗 ？ 
i get along with my younger brother . 	我 与 我 的 弟弟 相处 融洽 。 
none of the money is yours . 	这些 钱 都 不是 你 的 。 
the population of london is much greater than that of any other bri@@ ti@@ sh city . 	伦敦 的 人口 远远 多 于 其他 英国 城市 的 人口 。 
to be always honest is not easy . 	要 一直 诚实 是 不 容易 的 。 
there 's no mistake . 	没有 错误 。 
a consider@@ able amount of time and effort have been spent already . 	已经 花费 了 很多 的 时间 和 精力 。 
the apple tree has a beautiful blo@@ sso@@ m . 	苹果树 上 挂 着 美丽 的 花朵 。 
i 've finished writing the letter . 	我 已 经写 完信 了 。 
hurry , and you will catch the train . 	快 一点 ， 你 就 能 赶上 火车 了 。 
tom is looking for someone to take mary 's place . 	Tom 正在 找 其他人 代替 Mary 。 
`` she likes music . '' `` so do i . '' 	“ 她 喜欢 音乐 。 ” “ 我 也 是 。 ” 
he never speaks unless spoken to . 	除非 有人 跟 他 说 话 ， 他 从 来 不 说 话 。 
he usually goes to work at 8 a@@ .m . 	通常 ， 他 早上 8 点去 上班 。 
you 've given me good advice . 	你给 了 我 很 好 的 建议 。 
maybe that wo n't happen . 	也许 那 没 有 发生 。 
shut all the doors and windows . 	关闭 所有 的 门和 窗户 。 
tom was n't as handsome as mary said he was . 	汤姆 并 不是 玛丽 说 得 那样 英俊 。 
how did tom get out of jail ? 	汤姆 是 如何 出狱 的 ？ 
he threw a stone at the dog . 	他 朝着 狗 扔 了 块 石头 。 
i have n't met her . 	我 没有 遇见 她 。 
i am going to stay here for a couple of days . 	我将 要 在 这里 待 几天 。 
what 's the meaning of this word ? 	这个 字 的 意思 是 什么 ？ 
what did you do last night ? 	你 昨天 晚上 做什么 ? 
leave my car alone . 	不要 碰 我的车 。 
if i 've mis@@ jud@@ ged you , i 'm terri@@ bly sorry . 	如果 我 对 你 产生 误解 ， 我 实在 抱歉 。 
tom might be a vege@@ tari@@ an . 	汤姆 可能 是 素食 者 。 
i have no particular reason to do so . 	我 没有 特别 的 理由 去 做 。 
as soon as he sat down , he picked up the telephone . 	他 一 坐下 ， 就 拿 起 了 电话 。 
i do n't like either tea or coffee . 	我 不 喜欢 茶 也 不 喜欢 咖啡 。 
i have asked him . 	我 问过 他 。 
i 'm coming home , tom . 	我 在 回家 ， 汤姆 。 
i think you 're a lot stronger than you know . 	我 认为 你 比 你 想象 的 更 强 。 
i have no time . 	我 没 时间 。 
he wants to get a new dictionary . 	他 想得到 一本 新 的 字典 。 
the boy has learned to read . 	男孩 学会 了 阅读 。 
i 've never underesti@@ ma@@ ted tom . 	我 从没 低估 汤姆 。 
she accused me of telling a lie . 	她 指责 我 说 谎 。 
what 's your occu@@ pa@@ tion ? 	您 的 职业 是 什么 ？ 
the teacher said that the earth is round . 	老师 说 地球 是圆 的 。 
i 'm able to speak . 	我能 说 。 
you may make use of his library . 	你 可以 利用 他 的 图书馆 。 
it was really cheap . 	它 真的 很 便宜 。 
do you have anything to say ? 	你 有 任何 话 要 说 吗 ？ 
tom will try and stop me for sure . 	汤姆 一定 会试 着 阻挡 我 。 
do n't be disappointed . 	不要 失望 。 
keep away from the electri@@ cal equi@@ p@@ ment . 	远离 电器 设备 。 
have you finished reading that book ? 	你 读完 那 本书 了 吗 ？ 
we 'll meet again . 	后会有期 。 
mother prepared lunch for me . 	妈妈 为 我 准备 了 午饭 。 
i broke a glass when i did the dishes . 	我 做菜 时 打 了 个 玻璃杯 。 
if you 're wrong , then i 'm wrong , too . 	如果 你 错 了 ， 那么 我 也 错 了 。 
did you go out last night ? 	你 昨天 晚上 出去 了 吗 ？ 
i 'm the one who has to do this . 	我 是 必须 去 做 这事 的 人 。 
i 'm sorry i was n't able to see you when you came by today . 	我 很 抱歉 今天 您 来 的 时候 没能 见 您 。 
i was nervous , too . 	我 也 紧张 。 
you should make an effort to stop smoking . 	你 应该 努力 去 戒烟 。 
can you explain why you were late ? 	你 能 解释 一下 你 为 什么 迟到 吗 ？ 
i want to take a bath . 	我要 洗澡 。 
i will never for@@ ce you to marry him . 	我永远 不会 逼 你 跟 他 结婚 。 
i went on reading . 	我 继续 阅读 。 
i walked in the woods by myself . 	我 自己 走进 了 树林里 。 
tom lit his ci@@ gar . 	汤姆点 了 雪茄 。 
do you still want to give me a hug ? 	你 还想给 我 一个 拥抱 吗 ？ 
i 'm brea@@ st-@@ fe@@ eding my baby . 	我 喂 我 的 孩子 母乳 。 
where 's the dining room ? 	餐厅 在 哪里 ？ 
he was elected mayor . 	他 被 选为 市长 。 
i 've forgotten his name . 	我 已经 忘 了 他 的 名字 。 
let me die . 	让 我 去 死 。 
his advice did n't help much . 	他 的 忠告 没 起到 太大 的 作用 。 
are you a college student ? 	你 是 大学生 吗 ？ 
tom goes to work by motorcycle . 	汤姆骑 摩托 车 上班 。 
i wo n't be fooled . 	我 不会 上当 的 。 
tom has a pretty big mouth . 	汤姆 是 一个 大 嘴巴 。 
i do not love him anymore . 	我 已经 不爱 他 了 。 
i should clean my room . 	我 应该 打扫 我 的 房间 。 
they now have three children . 	现在 他们 有 三个 孩子 。 
you run . 	你 跑 。 
tom took the concert ticket mary offered him . 	汤姆 拿 了 玛丽 给 他 的 音乐会 票 。 
i wish i were young . 	但愿 我 还年 轻 。 
i 'll admit i 'm wrong . 	我承认 我 错 了 。 
i go to the library two or three times a week . 	我 一周 去 图书馆 两 、 三次 。 
my sister married her high school classmate . 	我 的 姐姐 嫁给 了 她 的 高中 同学 。 
for what purpose ? 	为 了 什么 目的 ？ 
he was paid 10,000 dollars . 	有人 付给 他 10000 美元 。 
did you buy her something for christmas ? 	你 圣诞节 买 东西给 她 了 吗 ? 
tom hung his jacket in the hall closet . 	汤姆 把 他 的 夹克 挂 在 大厅 衣柜 里 。 
why are you being so secre@@ tive ? 	你 为 什么 这么 神秘 ？ 
may i be the first to offer my congratulations . 	或许 我 是 第一个 给 你 祝贺 的 人 。 
i 'd like three p@@ ounds of chicken . 	我要 三 磅 的 鸡肉 。 
i was afraid i might be late . 	我怕 我 可能 迟到 了 。 
do you have any smaller si@@ zes ? 	你 有 任何 比较 小 的 尺寸 吗 ? 
she made a new suit for him . 	她 做 了 一套 新 衣服 给他 。 
do you know how to drive a car ? 	您 会 开车 吗 ？ 
i crossed the river by boat . 	我 乘船 过 了 河 。 
do n't you have anything to eat ? 	你们 有 什么 不吃 的 吗 ？ 
these apples look very fresh . 	这些 苹果 看起来 很 新鲜 。 
the oranges in this bag are rotten . 	这个 袋子 里的 柳橙都烂 了 。 
i was at the theater . 	我 在 剧场 。 
it was raining when we arrived . 	我们 到 的 时候 正在 下雨 。 
do people in your country eat rice ? 	在 您 国家 的 人 是 吃 米 饭 的 吗 ？ 
waiter , i 'd like to order . 	服务生 ， 我要 点菜 。 
he 's a tall boy . 	他 是 一个 高大 的 男孩 。 
his cottage is on the coa@@ st . 	他 的 村屋 在 海岸 上 。 
i had her swe@@ ep my room . 	我 让 她 打 扫 了 我 的 房间 。 
the things he says are not the least bit important . 	他 说 的话 根本 毫无 意义 。 
he is learning how to drive a car . 	他 正在 学 怎么 开车 。 
this apple is very red . 	这 只 苹果 非常 红 。 
turn the radio down a little . 	把 收音机 的 声音 关小一点 。 
i was truly astoni@@ shed . 	我 真是 惊讶 。 
the price of eggs is going up . 	蛋 的 价格 正在 上涨 。 
`` trust me , '' he said . 	“ 相信 我 。 ” 他 说 。 
this book 's new . 	这 本书 是 新 的 。 
i ca n't wait to go on a vacation . 	我 等不及 要 去 度假 。 
i speak english every day . 	我 每天 都 说 英语 。 
i 'm too sleepy to do my homework . 	我 太累 了 ， 做不了 功课 。 
real friendship is more valuable than money . 	真正 的 友谊 比 金钱 更 有 价值 。 
please remember to mail the letter . 	请 记得 把 信 寄 出去 。 
i think that 's awful . 	我 看 那 糟 透 了 。 
i am waiting for the store to open . 	我 正 等 著 这家店 开门 。 
i 'd like to invi@@ te you to the party . 	我 想 请 你 参加 派对 。 
this car is n't worth repa@@ ir@@ ing . 	这辆车 不 值得 修理 。 
i am blind in the right eye . 	我 的 右眼 瞎 了 。 
do n't play in the road . 	别 在 马 路上 玩 。 
we swam until it got dark . 	我们 游泳 到 天黑 。 
i sell clothing on@@ line . 	我在网 路上 卖 衣服 。 
tom does n't like doing homework . 	汤姆 不 喜欢 做 作业 。 
i got a far@@ e@@ well present from everyone . 	每个 人 都 送 了 我 一份 欢送 礼物 。 
it looks like an orange . 	它 看 起来 像 橙子 。 
come in , the door 's open . 	进来 , 门是 开 的 。 
i want to see your older sister . 	我 想 见 你 姐姐 。 
maybe some other time . 	也许 下 一次 吧 。 
in a cri@@ sis , you must get in touch with your teacher . 	在 危险 的 时候 你 必须 跟 你 的 老师 联 系 。 
there is a computer on the table . 	桌子 上 有 一 台 电脑 。 
let 's talk about this tomorrow . 	我们 来 讨论 下 明天 吧 。 
this job does n't pay . 	这个 工作 没有 酬劳 。 
what tri@@ ps are you planning ? 	你 在 计划 什么 出游 吗 ？ 
i 'll take you to the bus stop . 	我会 带 你 到 公交车 站 。 
she is old enough to know better . 	她 年 纪够 大该 懂事 了 。 
we must never con@@ fu@@ se the two . 	我们 决不能 混淆 两者 。 
you 're still green . 	你 还 年轻 。 
i ca n't understand this at all . 	我 一点 也 不 懂 这个 。 
she liked him right off . 	她 立刻 喜欢 上 他 了 。 
do n't ask me for money . 	不要 问我要 钱 。 
you do n't need to work on sundays . 	星期天 的 时候 ， 你 不用 工作 。 
i am a stranger here . 	我 是 这里 的 外地人 。 
he 's three years older than me . 	他 比 我 大三 岁 。 
tom had no children . 	Tom 没有 孩子 。 
i 'm very busy today . 	我 今天 很忙 。 
tom nearly died tonight . 	汤姆 昨晚 差点 死 了 。 
you have to come with me . 	你 必须 跟 我 来 。 
i decided to buy a car . 	我 决定 买 一辆车 。 
he is going to be an engineer . 	他 将成 为 一名 工程 师 。 
he confessed to the murder . 	他 供认 了 杀人 的 罪行 。 
he has n't answered my letter yet . 	他 还 没回 我 的 信 。 
he is a baseball player . 	他 是 个 棒球 手 。 
tom is afraid of heights . 	汤姆 恐高 。 
she cal@@ med down . 	她 冷静 下来 。 
life is very hard . 	人生 良苦 。 
i used to eat like a pi@@ g . 	我 曾经 像 猪 一样 吃 。 
are you saying that you give up ? 	你 是 说 你 放弃 了 吗 ？ 
can you name one of their songs ? 	你 能够 说出 一首 他们 的 歌 的 名字 吗 ？ 
the baby can not use a spoon yet . 	宝宝 还 不会 使用 勺子 。 
although the government refu@@ ses to admit it , its economic policy is in ru@@ ins . 	尽管 政府 拒绝 承认 ， 它 的 经济 政策 还是 失败 了 。 
i do n't like the food at that del@@ i . 	我 不 喜欢 那家 熟食 店里 的 食物 。 
i love her so much i could die . 	爱 她 爱得 要命 。 
i saw a horse pu@@ lling a car@@ t . 	我 看 见 一匹 马 拉 著 一架 马车 。 
tell them we 're coming . 	告诉 他们 我们 要来 了 。 
you should keep your mouth shut . 	你 应该 闭上 你 的 嘴 。 
i have nothing to do with the crime . 	这个 犯罪 和 我 一点 关系 都 没有 。 
i learned to drive a car when i was eighteen and got a driver 's license . 	我 十八 岁 时 ， 学了 开车 、 考到 了 驾照 。 
tom apologi@@ zed for what he did . 	汤姆为 他 所 做 的 事 道歉 。 
it 's no big deal . 	这 没什么 大不了 的 。 
we 'll fly there in 50 minutes . 	50 分钟 之 内 我们 将飞到 那里 。 
i 'm innocent . 	我 是 清白 的 。 
i 'm coming to see you tomorrow . 	我 明天 会来 看 你 。 
i bought two loa@@ ves of bread . 	我 买 了 两条 面 包 。 
that 's right ! 	对 了 ！ 
i 'm not the boss . 	我 不是 老 板 。 
whether he comes or not , the result will be the same . 	他来 还是 不来 ， 结果 是 一样 的 。 
tom does n't eat red meat . 	汤姆 不吃 红肉 
i wo n't be home next sunday . 	我下 周日 不 在家 。 
do we have enough food ? 	我们 有 足够 的 食物 吗 ？ 
my brother is not as tall as i was two years ago . 	我 弟弟 没 我 两年 前高 。 
i do n't have a good feeling about this . 	我 觉得 这 没什么 好 。 
europe has a smaller population than asia . 	欧洲 的 人口 比 亚洲 少 。 
tom and i are in the same class . 	汤姆 和 我 在 同一 个班里 。 
i live here . 	我 住 在 这 。 
i 'm sorry , i di@@ al@@ ed the wrong number . 	对 不起 ， 我 拨 错 了 号码 。 
there was a shor@@ tage of fuel . 	燃料 短缺 。 
all of the cookies are in the shape of stars . 	所有 饼干 都 是 星星 的 形状 。 
we had a kid just last year . 	就 在 去年 我们 有 了 一个 孩子 。 
it needs to be repaired . 	它 需要 修理 。 
he gave it a new name . 	他 给 了 它 一个 新 名字 。 
she cut the apple with a knife . 	她 用 刀子 切 苹果 。 
what 's wrong with my plan ? 	我 的 计划 有 问题 吗 ？ 
thank you , i 've had enough . 	谢谢 你 ， 我 吃 饱 了 。 
do n't bother me . 	别来 烦 我 。 
would you please explain the rules to me ? 	请 你 为 我 解释 规则 好 吗 ? 
where are those people from ? 	那些 人 从 哪来 的 ？ 
do you know what i 'm doing ? 	你 知道 我 在 做 什么 吗 ？ 
come home . 	回家 吧 。 
tom did n't doubt that there would be a lot of people there . 	汤姆 确定 那里 会 有 很多 人 。 
is the work hard ? 	工作 困难 吗 ？ 
i wish you 'd go . 	我 希望 你 去 。 
pass me the salt , would you ? 	把 盐 递给 我 好 吗 ？ 
please do n't tell your parents this . 	请 不要 告诉 你 父母 。 
please bring me my bill . 	请 把 帐单给 我 。 
i know why tom is studying french . 	我 知道 为 甚么 汤姆学 法语 。 
tom wondered why there was a dog in his house . 	汤姆 奇怪 为什么 他 的 房子 里 有 只 狗 。 
all their efforts were in va@@ in . 	他们 的 努力 都 白费 了 。 
i want something hot to drink . 	我想 喝点热 的 饮料 。 
we should tell children how to protect themselves . 	我们 应该 告诉 孩子 怎么 保护 自己 。 
help yourself to a piece of cake . 	你 自己 拿 蛋糕 吃 吧 。 
i 've had to do everything by myself . 	我 必须 靠 自己 做 所有 事 。 
that 's true . 	这是 真的 。 
please knock before entering . 	进来 之前 请 敲门 。 
my mother was an alco@@ holi@@ c . 	我 母亲 是 个 酒鬼 。 
why should i apologize to you ? 	为什么 我要 向 你 道歉 ？ 
give her the book . 	把 这 本书 给 她 。 
please translate this sentence into japanese . 	请 把 这句 话 翻译成 日文 。 
this guy looks like a fox . 	这 家伙 像 个 狐狸 。 
he appeared at last . 	他 终于 出现 了 。 
he was very friendly to everybody . 	他 对 每个 人 都 非常 友善 。 
i 'm feeling good this morning . 	我 今天 早晨 感觉 良好 。 
we 'll go when it qui@@ ts raining . 	雨停 了 我们 就 会 去 。 
please help me clean the house . 	请 帮 我 打 扫 房子 。 
tom 's uncle keeps a lot of sheep . 	汤姆 的 叔叔 养 了 很多 羊 。 
he does n't know how to write a letter in english . 	他 不 知道 如何 用 英语 写信 。 
sorry , but i ca n't hear you very well . 	对 不起 ， 但 我 听 不清 你 说 的 话 。 
he brought me to the bus stop . 	他 带 我 到 车站 。 
he made his way to the minister . 	他 设法 当上 了 部长 。 
he can read well enough . 	他 能 读 得 很 好 。 
who was playing ? 	谁 在 玩 ？ 
do n't you think so ? 	你 不 这么 认为 吗 ？ 
i 've missed another chance . 	我 又 失去 了 一次 机会 。 
i got sick from drinking too much . 	因为 喝酒 喝太多 ， 所以 我 生病 了 。 
where is my umbrella ? 	我 的 伞在 哪 ？ 
nobody likes being laughed at . 	没 有人 喜欢 被 人 嘲笑 。 
i am in favor of your proposal . 	我 赞成 你 的 建议 。 
not everything can be bought with money . 	不是 所有 的 东西 都 可以 用金钱 买 到 。 
i am not afraid of dying . 	我 不怕死 。 
where can i go to get a map of europe ? 	去 哪里 可以 买到 欧洲 的 地图 ？ 
the last person i told my idea to thought i was nu@@ ts . 	最后 一个 听 我 说 我 的 主意 的 人 认为 我 疯 了 。 
admission to the museum is thirty dollars . 	博物 馆入 场费 是 三十 美元 。 
tom has his own problems . 	汤姆 有 他 自己 的 问题 。 
what a beautiful flower ! 	多 漂亮 的 花 啊 ! 
i am near the station . 	我 在 车站 附近 。 
english has now become the common language of several nations in the world . 	英语 现已 成为 世界 上 许多 国家 的 通用 语言 了 。 
he 's a professor of bio@@ logy at harvard . 	他 是 哈佛大学 的 生物学 教授 。 
i feed my cat every morning and every evening . 	每天 早晚 ， 我 给 我 的 猫 喂食 。 
tom has lived in boston for over a year . 	汤姆 住 在 波士顿 已经 一年 多 了 。 
there is not much traffic on this road . 	这条 路上 的 车辆 不多 。 
what woke you up ? 	什么 吵醒 你 了 ? 
when i was your age , pl@@ u@@ to was a planet . 	当我 在 你 这个 年 纪时 ， 冥王星 是 行星 。 
do you study english ? 	您 学 英语 吗 ？ 
she is always dressed in black . 	她 总 是 穿 著 黑色 的 衣服 。 
my boyfriend is a jour@@ na@@ list . 	我 男朋友 是 个 记者 。 
how are you doing in school ? 	学校 怎么样 ？ 
i 've never seen tom laugh . 	我 从 没见 汤姆笑 。 
india gained in@@ depen@@ dence from britain in 19@@ 4@@ 7 . 	印度 于 1947 年 脱离 英国 获得 独立 。 
i finally persu@@ ad@@ ed him to buy it . 	我终 于 说 服 了 他 买 它 。 
how are you , tom ? 	你好 吗 ， 汤姆 ？ 
the cause of the fire was un@@ known . 	火灾 的 原因 不明 。 
it 's very hot in this room . 	这间 房里 很热 。 
that changed everything . 	那 改变 了 一切 。 
i do n't want tom to do that alone . 	我 不想 让 汤姆 自己 做 。 
this was the most interesting book that she had ever read . 	这是 她 读过 最 有趣 的 书 。 
she may be proud of her daughter . 	她 可以 为 她 的 女儿 感到 骄傲 。 
wash your feet . 	洗 你 的 脚 。 
i wish you the best of luck . 	祝 你好 运 。 
why do you let tom treat you that way ? 	你 为 甚么 让 汤姆 那么 对 待 你 ？ 
they refused . 	他们 拒绝 了 。 
we 're special . 	我们 很 特别 。 
someone has taken my shoes by mistake . 	有人 穿错 了 我 的 鞋 。 
he is a bad driver . 	他 是 个 糟糕 的 司机 。 
that patient may die at any time . 	病人 随时 会 死 。 
i wish i had seen her . 	但愿 我 见过 她 。 
i 'm sorry , i forgot to do my homework . 	对不起 ， 我 忘 了 作业 这 回事 了 。 
i thought tom would want to know about that . 	我本 以为 汤姆 愿意 了解 这件 事 。 
i was very impressed by his story . 	我 被 他 的 故事 感染 了 。 
i succeeded in getting what i wanted . 	我 成功 地 得到 了 我 想要 的 。 
is there a hotel around here ? 	附近 有 酒店 吗 ？ 
i plan to break up with her . 	我 打算 与 她 分手 。 
i 've been told that you 're a very compe@@ tent person . 	有人 说 你 是 个 很 有 能力 的 人 。 
when i heard that song , it remin@@ ded me of when i was a kid . 	我 听 到 那 首歌 时 ， 它 让 我 想起 了 我 小 的 时候 。 
tom is lucky he did n't get shot . 	汤姆 没 被 射中 真走运 。 
will you please hold this e@@ dge ? 	能 不能 请 你 拿 着 这端 ？ 
no one understands me . 	没有 人 理解 我 。 
it was a great sho@@ ck to me . 	这对 我 是 很大 的 震撼 。 
the mountain was covered with snow . 	这座 山 被 雪覆盖 著 。 
someone is lying . 	有人 说谎 。 
let your hair down a little . 	稍微 随意 一点 。 
i do n't like my hair at all . 	我 根本 不喜欢 我的头 发 。 
he 's my new friend . 	他 是 我 新交 的 朋友 。 
that 's my coat . 	那 是 我 的 大衣 。 
you 'd better go to bed at once . 	你 最好 马上 去 睡觉 。 
does she speak english ? 	她 会 说 英语 吗 ？ 
when i woke up , it was snowing . 	当我醒 来 时 ， 天正 下著雪 。 
i 've been to australia three times . 	我 去过 澳洲 三次 。 
he always plans a thing out carefully before he does it . 	他 每件 事 做 之前 都 会 细心 计划 。 
what happened then ? 	然后发生 了 什么 事 ？ 
his wife is quite a talented woman . 	他 老婆 很 有 才 。 
please help yourself to the cake . 	你 自己 拿 蛋糕 吃 吧 。 
keep to the right . 	靠 右侧 通行 。 
we spent the weekend with friends . 	我们 和 朋友 一起 度过 周末 。 
i asked her to wait a minute . 	我 让 她 等 了 一分钟 。 
hope@@ fully , we 'll enjoy our china trip . 	希望 我们 会 喜欢 我们 的 中国 之 旅 。 
you should read a lot of books while you 're young . 	应该 趁 年轻 多读 点书 。 
go at once , o@@ ther@@ wise you will be late . 	立刻 走 ， 否则 你 会 迟到 。 
i wonder whether or not tom can speak french . 	我 不 知道 汤姆会 不会 说 法语 。 
she was in america last month . 	她 上 个 月 在 美国 。 
the teacher got quite well again . 	老师 再次 恢 复 健康 了 。 
please do n't look at me like that . 	请 不要 那样 看 我 。 
i wanted to go to the concert . 	我本 想 去 参加 音乐会 的 。 
tom went home alone . 	汤姆 一个 人 回家 了 。 
tom asked if i 'd found my key . 	汤姆问 我 找到 我 的 钥匙 了 吗 。 
no fe@@ wer than 50 passengers were killed . 	不下 50 个 乘客 死 了 。 
you could say that . 	你 不能 这么 说 。 
if we were supposed to talk more than listen , we would have been given two mou@@ ths and one ear . 	如果 我们 应该 少 听 多 说 话 , 那么 我们 应该 得到 两个 嘴巴 一 只 耳朵 才 是 。 
he is able to speak five languages . 	他会 说 五种 语言 。 
i 've lost a little weight . 	我 瘦 了 一点 。 
stop bo@@ ther@@ ing me . 	不要 烦 我 。 
this is the chea@@ pest shop in town . 	这是 镇上 最 便宜 的 商店 。 
i 'm counting on your help . 	我 指望 你 的 帮助 。 
i was the happi@@ est man on earth . 	我 曾 是 世界 上 最 幸福 的 男人 。 
they made their way through the crowd . 	他们 从 人群 中挤 过去 了 。 
the mountain has a beautiful shape . 	这座 山有 一个 美丽 的 外形 。 
are you all ready ? 	你们 都 准备 好 了 吗 ? 
he is a man of few words , but he always keeps his promise . 	他 这个 人话 不 多 ， 但 总是 遵守 诺言 。 
he is known as a great poet . 	他 以 一个 伟大 的 诗人闻名 。 
tom has no brothers or sisters . 	Tom 没有 兄弟 也 没 有 姊妹 。 
can you put some sun@@ t@@ an lo@@ tion on my back ? 	你 能 在 我 的 背上 涂些 防晒霜 吗 ？ 
do n't be terri@@ fied . 	别 被 吓坏 了 。 
the rumor pro@@ ved to be true . 	经过 证实 ， 谣言 是 真的 。 
i 'm fine . 	我 很 好 。 
those two are exactly a@@ like . 	那 两个 是 一模 一样 的 。 
which credit cards can i use ? 	我 可以 用 哪些 信用卡 ？ 
i slept on the bus . 	我 在 公交车 上 睡觉 了 。 
the youngest daughter is excep@@ tion@@ ally beautiful . 	么 女长 得 特别 漂亮 。 
your c@@ v has really impressed me . 	你 的 履历给 我 留下 深刻 的 印象 。 
would you like to eat something ? 	你 想 吃点 东西 吗 ？ 
i was in the garden all afternoon . 	我 整个 下午 都 在 花园里 。 
where is the wedding to be ? 	婚礼 在 哪儿 举行 ？ 
i wonder if you have something to write with . 	我 怀疑 你 是否 有 东西 可 写 。 
stay right here and relax . 	待 在 这里 ， 放 松 。 
i do n't like wine . 	我 不 喜欢 红酒 。 
fill in your name and address . 	填上 你 的 姓名 和 地址 。 
i 'll be able to as@@ sist you . 	我能 协助 你 。 
she refused my offer to help her . 	她 拒绝 让 我 帮助 她 。 
tom has n't done anything . 	汤姆 什么 都 没 做 。 
he could n't get the job . 	他 无法 得到 这份 工作 。 
i have never fed my dog a banan@@ a . 	我 从 没给 我 的 狗 喂过 香蕉 。 
i held my breath and waited . 	我 屏住 了 呼吸 等待 着 。 
i do n't know your reasons for not li@@ king tom . 	我 不 知道 你 不 喜欢 汤姆 的 理由 。 
she looks young . 	她 看起来 很 年轻 。 
excuse me , let me point out three mistakes in the above article . 	不好意思 ， 让 我 指出 先前 文章 的 三个 错误 。 
you ought to have come to our party . 	你 应该 到 我们 的 派 对 的 。 
kyoto and boston are sister cities . 	京都 和 波士顿 是 姐妹 城市 。 
tom needs to up@@ date his website . 	汤姆 需要 更新 他 的 网站 。 
you can take today off . 	你 今天 可以 休假 一天 。 
you look very pale . 	你 看上去 很 苍白 。 
it 's a sun@@ flower . 	那 是 一朵 向日葵 。 
ignor@@ e tom . 	别理 汤姆 。 
do you com@@ mu@@ te to school by bus ? 	你 搭 公车 上下 学 吗 ？ 
you 'd better keep your money for a rainy day . 	你 最好 未雨绸缪 。 
the teacher can not have said such a thing . 	老师 不 可能 说 过 这样 的 事 。 
let 's skip out before tom gets back . 	咱在 汤姆 回来 之前 开溜 吧 。 
two for the lunch bu@@ ff@@ et , please . 	两人份 自助 午餐 ， 谢谢 。 
i used to play tennis in high school . 	我 高中 时 曾 打 网球 
turn on the radio , please . 	请 将 收音机 打开 。 
i know none of them . 	他们 中 的 任何 一位 我 都 不 认识 。 
exercise is good for your health . 	做 运动 有利于 健康 。 
who do you think we are ? 	你 认为 我们 是 谁 ？ 
this suit seems really expensive . 	这 西装 好像 真的 很贵 。 
i think my right arm is broken . 	我 想 我 的 右 手臂 断 了 。 
do you like japanese food ? 	你 喜欢 日本 料理 吗 ? 
she has a strong objection to my plan . 	她 强烈 反 对 我 的 计划 。 
i want some orange juice . 	我 想要 一点 柳 橙汁 。 
we left home early in the morning . 	我们 早上 很 早就 离开家 了 。 
tom was excited to go to the concert . 	汤姆 为 去 音乐会 而 激动 。 
i need some help with my work . 	我 在 我 的 工作 上 需要 一些 帮助 。 
i think i 'm right . 	我 想 我 是 对 的 。 
she took care of the children . 	她 照顾 孩子 们 。 
the police are investiga@@ ting the cause of the accident . 	警察 调查 事故 的 原因 。 
true love never grows old . 	真爱不会 变老 。 
japan is an extremely noisy country . 	日本 是 一个 非常 嘈杂 的 国家 。 
more coffee , please . 	请 再给 我 一点 咖啡 。 
everyone is waiting for tom . 	每个 人 都 在 等 汤姆 。 
she gave us lots to eat . 	她给 了 我们 很多 吃 的 东西 。 
it was foolish of you to accept his offer . 	你 真 笨 去 接受 他 的 提议 。 
i ca n't reach it . 	我 搆 不到 它 。 
he hates cleaning his room . 	他 讨厌 打扫 自己 的 房间 。 
cows are eating grass in the mea@@ dow . 	牛 吃 牧草 。 
do you go to church ? 	你 去 教堂 吗 ？ 
we go out together every weekend . 	我们 每个 周末 都 一起 出去 。 
i ca n't find my ticket . 	我 找 不到 我 的 票 。 
the train for bir@@ min@@ g@@ ham leaves from pla@@ t@@ form 3 . 	去 伯明翰 的 火车 从 3 号 站台 出发 。 
he has three brothers . 	他 有 三个 哥哥 。 
we made the most of the opportunity . 	我们 尽力 地 利用 了 这个 机会 。 
a hundred years is called a century . 	一百年 被 叫做 一个 世纪 。 
let 's begin with this problem . 	从 这个 问题 开始 吧 。 
she asked how to cook the fish . 	她 问 了 怎么 烧鱼 。 
she goes to school on foot . 	她 走路 去 上学 。 
when did you change your address ? 	你 什么 时候 更改 了 你 的 地址 ? 
it 's very easy to miss this kind of mistake . 	这种 错误 很 容易 被 人 忽视 。 
some of the blu@@ est water in the world is found in cra@@ ter lake . 	一些 世界 上 最 蓝 的 水 在 火山 湖 。 
tom burst into tears . 	汤姆 泪流满面 。 
i bought this yesterday . 	昨天 我 买 了 这个 。 
tom told me he was nervous . 	汤姆 告诉 我 他 紧张 。 
i looked after him for a period of time . 	我 看 了 他 一段 时间 。 
tom told me that i should n't go out alone at night . 	汤姆 跟 我 说 我 不 应该 晚上 一个 人 出门 。 
you 're ir@@ re@@ si@@ sti@@ ble . 	你 令人 难以 抗拒 。 
where is the police station ? 	警察局 在 哪里 ？ 
i had a dream about him . 	我梦到 了 他 。 
he read the letter over and over . 	他 把 信读 了 一遍 又 一遍 。 
it 'll cost about 10,000 yen . 	它 将花费 大约 10 , 000 日元 。 
i was tired today so i went to bed early . 	我 今天 累 ， 所以 我 睡 得 早 。 
the po@@ lar b@@ ears are dying . 	北极熊 正在 死去 。 
au@@ ck@@ land is a city in new zealand . 	奥克兰 是 一座 新西兰 的 城市 。 
he threw a rock into the pond . 	他 扔 了 一块 石头 到 池塘 里 。 
flying is the qui@@ cke@@ st way to travel . 	搭飞机 是 最快 的 旅行 方式 。 
you have everything . 	您 全都 有 。 
there are no problems . 	没有 问题 。 
do n't fail to mail this letter . 	不要 忘 了 寄 这 封信 。 
his son wants to be a lawyer . 	他 儿子 想当 律师 。 
i scre@@ wed up the very first note . 	我 搞 砸 了 第一 个 音符 。 
he took care of the business after his father 's death . 	在 他 父亲 死后 ， 他 接管 了 公司 。 
i 'm not your mother . 	我 不是 你们 的 妈妈 。 
is this the right train for tokyo ? 	这是 开往 东京 正确 的 火车 吗 ? 
do you have many friends ? 	你 有 很多 朋友 吗 ？ 
it is difficult to speak chinese well . 	很难 把 中文 说 得 好 。 
i wanted to show it to you . 	我 想 把 它给 你 看 。 
welcome to your new home . 	欢迎 来 到 你 的 新家 。 
ten minutes later , our car ran out of gas . 	我们 的 车 再 过 十分钟 就 没油 了 。 
it was really special . 	它 真特别 。 
he must be tom 's brother . 	他 一定 是 汤姆 的 兄弟 。 
you have no fever . 	你 没 发烧 。 
i had a vision . 	我 有 一个 愿景 。 
the space race was an exciting time in history . 	太空 跑步 是 历史 上 激动人心 的 时刻 。 
my parents ' gener@@ ation went through the war . 	我 父母 那 一代 经历 过 战争 。 
he never gave up hope that he would reach that goal . 	他 从 没放弃 达成 那个 目标 的 希望 。 
she asked him questions . 	她 问了 他 问题 。 
you 'll understand someday . 	你 有 一天 会 明白 。 
tom drank some orange juice . 	T 喝 了 点柳 橙汁 。 
what 's wrong , hon@@ ey ? 	出 什么 事 了 ， 宝贝 ？ 
could i see you a minute , please ? 	让 我 看 你 一会儿 好 吗 ? 
put the book back on the shelf . 	把 书放 回书 架上 。 
try to avoid making any more trouble . 	尽量 避免 制 造 任何 更 多 的 麻烦 。 
he swam until he could swim no more . 	他游到 不能 游 为止 。 
come in , it 's open . 	进来 ， 门开 着 。 
it 's getting dark . i wonder if it 's going to rain . 	天变 暗 了 。 我 不 知道 是不是 要 下雨 。 
i used to go out with friends every weekend . 	我 曾经 每 周末 都 和 朋友 外出 。 
bring me something to eat . 	给我 东西 吃 。 
i know those tall girls quite well . 	我 跟 那些 高个子 的 女孩 很 熟稔 。 
how can you do this to me ? 	你 怎么 这样 对 我 ？ 
did you get up early ? 	你 起床 早 吗 ？ 
i 'd like you to go there . 	我 希望 你 去 那里 。 
there 's an outside chance of winning . 	赢的 机会 微乎其微 。 
the most logi@@ cal place to keep your shoes is near the door . 	最合 逻辑 的 放鞋 处 是 门口 附近 。 
even children can read this book . 	即使 是 小孩 也 能 读 这本书 。 
where are you going to eat lunch ? 	你 要 去 哪里 吃 午饭 ？ 
how much is it ? 	它 多贵 ? 
i bought it for ten dollars . 	我花 10 美元 买 的 。 
what happened to him ? 	他 发生 了 什么 事 ？ 
he was in good spi@@ ri@@ ts . 	他 精神 很 好 。 
i always thought that tom was a bit different . 	我 以前 总 认为 汤姆 是 有 一些 与众不同 的 。 
where 's the vodka ? 	伏特加 在 哪里 ？ 
it does n't mean anything . 	这 什么 都 说明 不了 ！ 
i went there yesterday . 	昨天 我 去 了 那里 。 
this book is very thi@@ ck . 	这 本书 非常 厚 。 
the chicken is under@@ cooked . 	鸡肉 还不够 熟 。 
i succeeded in getting what i wanted . 	我 赢得 了 我 想要 的 。 
j@@ st stands for japan stan@@ dar@@ d time . 	JST 代表 日本 标准 时间 。 
it wo n't take long to finish the job . 	完成 这个 工作 不会 花太 长时间 。 
speak clearly . 	讲 清楚 。 
knowledge is power . 	知识 就是 力量 。 
do n't he@@ si@@ tate to ask questions . 	不要 犹豫去 问问题 。 
he bought his daughter a dress . 	他 买 了 一件 洋装给 他 女儿 。 
birds sing . 	鸟儿 歌唱 。 
you do n't need a gun . 	你 不 需要 枪 。 
only 3 out of the 9@@ 8 passengers survived . 	98 名 乘客 只有 3 人生 还 。 
help us reach our goal . 	帮助 我们 达成 目标 。 
you must be careful not to make him angry . 	你 要 小心 别 惹 他 生气 。 
he is a thief . 	这是 一个 小偷 。 
i ache all over . 	我 全身 酸痛 。 
please take more care in the future . 	请 你 将来 注意 点 。 
do you need an ambu@@ lance ? 	你 需要 救护车 吗 ? 
she teaches us french . 	她 教 我们 法语 。 
i wish she had come last night . 	要是 她 昨晚 来 就 好 了 。 
this is really terrible . 	这真 可怕 。 
i 'm very hungry now . 	我现 在 非常 饿 。 
english is taught in most countries . 	大部份 的 国家 都 教英语 。 
each student has a lo@@ ck@@ er . 	每个 学生 都 有 一柜子 。 
if he were a little younger , he would be e@@ ligi@@ ble for the post . 	如果 他 年轻 一点 ， 他 将 很 适合 这个 职位 。 
tom has never been in prison . 	汤姆 从 没 进过 监狱 。 
tom stopped me from entering the bank . 	汤姆 阻止 我进 银行 。 
he studies chinese as well . 	他 也 学习 汉语 。 
where do you work now ? 	你 现在 在 哪里 工作 ？ 
my mother bought two bottles of orange juice . 	我 母亲 买 了 两瓶 橙汁 。 
i want to see your mother . 	我 想 看看 你 的 母亲 。 
we were in danger of losing our lives . 	我们 曾 有 失去 生命 的 危险 。 
everything 's normal . 	一切 正常 。 
i will never see him again . 	我永远 不会 再 看到 他 。 
i wish you could come with us . 	但愿 你 可以 跟 我们 一起 来 。 
he was playing tennis all day . 	他 整天 打 网球 。 
whose is this bicycle ? 	这辆 自行车 是 谁 的 ？ 
come whenever you want to . 	什么 时候 想来 就 过来 吧 。 
i bought it last week . 	我 上 周买 了 它 。 
i finally found a job . 	我 终于 找到 工作 了 。 
he drives his own car . 	他开 他 自己 的车 。 
tom said he needed money . 	汤姆 说 他 需要 钱 。 
we have nothing in common . 	我们 没有 任何 共同 之处 。 
he spoke for one hour . 	他 讲 了 一 小时 。 
i 'll boil the potatoes for you . 	我 为 你 煮 马 铃薯 。 
she speaks both english and french . 	她 会 讲英语 和 法语 。 
my father retired at the age of 6@@ 5 . 	我 的 父亲 65 岁 的 时候 退休 了 。 
i 'm glad i could help you . 	能够 出 一份 力太好 了 。 
my father has five siblings . 	我 父亲 有 五个 兄弟 姐妹 。 
my aunt made me a new skirt . 	我 婶 婶 做 了 一条 新 裙子 给我 。 
there are four sea@@ sons in one year . 	一年 有 四季 。 
i have n't seen you for ages . do you remember when i saw you last ? 	好久 不见 了 。 记得 上次 我 什么 时候 看见 你 的 吗 ？ 
this one 's yours . 	这个 是 你 的 。 
all of my friends got asked to dance except me . 	除了 我 ， 其他人 都 被 邀请 去 跳舞 了 。 
can you use a computer ? 	您 会 使用 计算机 吗 ？ 
is that what it 's called ? 	那 就是 它 的 叫法 吗 ？ 
i must return home within a week . 	我 得 要 在 一 周内 回家 。 
he made fun of me in public . 	他 在 公共 场合 取笑 了 我 。 
there was a cottage on the side of the hill . 	山坡 上 有 一个 茅屋 。 
he lost his eyesight in the accident . 	他 在 意外 中 失明 了 。 
there were few people on the beach . 	沙滩 上 的 人 非常少 。 
a lot of trees were cut down . 	很多 树 被 砍 倒 。 
maybe tom just got nervous . 	可能 汤姆 紧张 了 。 
i like playing sports . 	我 喜欢 运动 。 
the teacher ga@@ th@@ ered his students around him . 	老师 把 他 的 学生们 聚集 在 他 周围 。 
this house belongs to my uncle . 	这栋 房子 属 于 我 的 叔叔 。 
the area was quiet . 	这地区 很安静 。 
i bought a new television . 	我 买 了 台 新 电视机 。 
perhaps she will come tomorrow . 	也许 她 明天 会来 。 
do n't let anyone press this button . 	别 让 任何人 按 这个 按钮 。 
do you know a good restaurant ? 	你 知道 一个 好 饭店 吗 ？ 
we took a walk along the river . 	我们 沿著河 散步 。 
what 're you after ? 	你 想要 什么 ？ 
tom hung the cal@@ en@@ da@@ r on the wall . 	汤姆 把 日 历 挂 在 墙上 。 
i will lend you this dictionary . 	我会 借给 你 这本 字典 。 
tom is swimming . 	汤姆 在 游泳 。 
i 'm amazed at his ra@@ pi@@ d progress in english . 	我 被 他 英语 的 快速 进步 惊呆 了 。 
why ca n't you come ? 	你 为 什么 不能 来 ? 
would you like to leave a message ? 	你 要 留言 吗 ？ 
i looked , but i did n't see anything . 	我 看过 了 , 但是 没 看到 什么 东西 。 
tom seems to speak french better than before . 	汤姆 讲 法语 看来 比 以前 好 。 
i have no place to sleep tonight . 	我 今晚 没 地方 睡觉 。 
you must go outside if you want to smoke . 	如果 您 想 抽烟 的话 ， 您 必须 出去 。 
what time will you leave ? 	你 什么 时候 离开 ？ 
i am not a wi@@ tch . 	我 不是 巫婆 。 
there was a castle here many years ago . 	许多年 前 这里 有 一座 城堡 。 
he ca n't seem to understand that poem . 	他 似乎 无法 理解 那首 诗 。 
all at once , i heard a cry . 	突然 ， 我 听到 了 一声 喊叫 。 
i want the same jacket as you are wearing . 	我 也 想要 和 你 身上 那件 同样 的 外套 。 
wi@@ res are used to conv@@ ey electricity . 	电线 被 用 来 运送 电力 。 
do n't ask tom any questions about his job . 	别问 汤姆 他 的 工作 的 问题 。 
these apples are very big . 	这些 苹果 很大 。 
they only sell women 's shoes here . 	这里 只卖 女鞋 。 
may i ask some questions ? 	我 可以 问 一些 问题 吗 ? 
we need to make a plan . 	我们 需要 做 计划 。 
`` do you speak german ? '' `` no , i do n't . '' 	" 你 说 德语 吗 ? " " 不 ， 我 不 说 。 " 
he is not the man that he was when i first knew him . 	他 已经 不是 我 最初 见 他 那时 的 那个 人 了 。 
i do n't think tom is going to be too much help . 	我 认为 汤姆 帮不上 大忙 。 
he talks as if he knows everything . 	他 说 起话 来 好像 他 什么 都 知道 。 
they have been married two years . 	他们 已经 结婚 两年 了 。 
i think tom is a@@ th@@ le@@ tic . 	我 认为 汤姆 好 运动 。 
may i go to the bathroom ? 	我 可以 去 洗手 间 吗 ？ 
he 's always been kind to me . 	他 总是 对 我 很 亲切 。 
he has a lot of original ideas . 	他 有 很多 独到 的 见解 。 
he 's doing his best . 	他 在 全力以赴 。 
children should drink milk every day . 	孩子 们 应该 每天 喝 牛奶 。 
he likes fishing . 	他 喜欢 钓鱼 。 
in the light of what you told us , i think we should re@@ vi@@ se our plan . 	根据 你 所说 的话 ， 我 认为 我们 应该 重新 审视 我们 的 计划 。 
i ca n't find him anywhere . 	我 在 哪儿 都 没 找到 他 。 
this message does n't make sense . 	这个 消息 没有 道理 。 
we accept che@@ cks . 	我们 接受 支票 。 
tom has a girlfriend in boston . 	Tom 有个 在 波士顿 的 女友 。 
my uncle lived abroad for many years . 	我 叔叔 住 在 国外 很多年 了 。 
i am almost 18@@ 0 centi@@ meters tall . 	我 差不多 180 公分 高 。 
it had to be tom that did that . 	一定 是 汤姆 做 的 。 
this is the big@@ gest car in the world . 	这是 世界 上 最大 的 车 。 
did you rent an apartment ? 	你 租 房子 了 吗 ？ 
foreign in@@ ve@@ sto@@ rs with@@ drew their money from america . 	外国 投资者 从 美国 收回 他们 的 钱 。 
i asked him where he was going . 	我问 了 他 要 去 哪里 。 
industry as we know it today did n't exist in those days . 	我们 今天 所 认识 的 工业 在 那个 时代 不 存在 。 
it was a very stupid decision . 	这是 一个 十分 愚蠢 的 决定 。 
what is the total amount of money you spent ? 	你 一共 花 了 多少 钱 ？ 
your order has been sub@@ mi@@ tted . 	您 的 订单 已经 提交 了 。 
this little girl let the birds escape . 	这个 小女孩 让 小 鸟 脱 逃 了 。 
you 're not fast enough . 	你 不够 快 。 
she had died before i arrived . 	她 在 我 到 达 之前 去世 了 。 
this dress cost me over 4@@ 0,000 yen . 	这件 衣服 花 了 我 40000 日元 。 
who invited you guys ? 	谁 邀 请 了 你 们 ？ 
stop shooting . 	停止 射击 。 
who do you think i am ? 	你 把 我 当 什么 啦 ？ 
do you smoke ? 	您 吸烟 吗 ？ 
tom did n't have a fever this morning . 	汤姆 今天 早上 没有 发烧 。 
my father is reti@@ ring next spring . 	我 爸爸 明年 春天 就要 退休 了 。 
let 's as@@ su@@ me that 'll happen . 	让 我们 假定 那会 发生 。 
i would like to help you . 	我 愿意 帮 你 。 
he will be back in a second . 	他 很快 就 会 回来 。 
we got up at dawn to avoid a traffic jam . 	我们 黎明 时 起床 以 避开 交通 堵塞 。 
i 'm sorry . i got the wrong number . 	对 不起 ， 我 拿 错 了 号码 。 
this desk is mine . 	这张 书桌 是 我 的 。 
tom wrote his name in the sand with a stick . 	汤姆 用 棍子 在 沙上 写 了 他 的 名字 。 
he 's sitting at an empty table . 	他 坐在 一张 空 桌旁 。 
he tried to kill himself . 	他 试图 自杀 。 
she is a famous singer . 	她 是 一个 著名 的 歌手 。 
he got hurt when he fell down . 	他 跌倒 的 时候 受 了伤 。 
have you finished your homework ? 	你 做 完作业 了 吗 ？ 
it snowed for ten con@@ secu@@ tive days . 	雪 持续 下 了 十天 。 
i always take a bath before going to bed . 	我 睡觉 前 总要 洗个 澡 。 
he seldom , if ever , goes to church . 	他 很少 ， 如果 有 的 话 ， 去 教堂 。 
my father walks . 	我 爸爸 走路 。 
my plan is to buy a car . 	我 打算 买辆车 。 
iron the inside of co@@ ll@@ ars first , and then the outside . 	先 熨烫 领子 的 里面 ， 然后 是 外面 。 
what goes up must come down . 	会起 必会落 。 
the fact is that he did n't even take the exam . 	实际上 他 根本 没有 去 考试 。 
it took us a long time to decide what we really wanted to do . 	我们 花 了 很长 时间 决定 我们 真正 想 的 事 。 
this pen does n't write well . 	这 支笔 不太好 用 。 
i do n't think it 's going to be easy to find tom . 	我 认为 ， 要 找到 汤姆 可不 容易 。 
that 's the other reason i 'm here . 	那 是 我 在 这里 的 另外 一个 理由 。 
i wish i knew where he was ! 	但愿 我 知道 他 在 哪里 。 
i do n't like the way he talks . 	我 不 喜欢 他 讲话 的 样子 。 
none of them could understand what she was im@@ pl@@ ying . 	他们 没 有人 了解 她 暗示 什么 。 
our native language is japanese . 	我们 的 母语 是 日语 。 
he is now either in rome or in paris . 	他 不是 在罗马 ， 就是 在 巴黎 。 
it 's very special . 	它 很 特别 。 
i work too much . 	我 工作 得太多 了 。 
tom came to the conclu@@ sion that no matter what he did , mary would n't like it . 	汤姆 得出 无论 他 做 什么 ， 玛丽 都 不会 喜欢 的 结论 。 
he loves to fish . 	他 酷爱 钓鱼 。 
he goes to school to study every day . 	他 每天 去 学校 学习 。 
why do n't we have dinner ? 	为 甚么 我们 不吃 晚饭 ？ 
why did you buy a japanese car ? 	你 为 甚么 买 日本 车 ？ 
he has been dead for ten years . 	他 已 经死 了 十年 。 
i wish that tom would agree to do that . 	我 希望 汤姆能 同意 。 
they got to the hotel after dark . 	天暗 后 他们 到 了 酒店 。 
tom is out of your lea@@ gue . 	汤姆 不 在 你 的 联盟 里 。 
what time did you get up this morning ? 	你 今天 几点 起 的 床 ？ 
my father takes a walk every morning . 	我 父亲 每天 早上 去 散步 。 
it can be dangerous . 	它 有 危险 。 
when was it built ? 	它 是 什么 什么 时候 盖 的 ？ 
i studied for a while this morning . 	我 今天 早上 读 了 一会儿 书 。 
i 'm not going to do anything to you . 	我 不会 对 你 做 任何 事 。 
let 's keep in touch . 	让 我们 保持 联络 。 
it was not very cold yesterday . 	昨天 不是 很 冷 。 
you 're the one who suggested that we do that together . 	你 是 那个 建议 我们 一起 做 那件 事 的 人 。 
the house is not occupied now . 	房子 现在 没 被 占 住 。 
mars is a planet . 	火星 是 一颗 行星 。 
my aunt gave me an album . 	我 姑姑 给了 我 一本 相簿 。 
i 'm thirsty . 	我渴 了 。 
he runs a supermarket in the town . 	他 在 这个 镇上 经营 一家 超级 市场 。 
i want to see you again . 	我 希望 再次 见 到 你 。 
could you check the tire pressure ? 	你 能 检查 一下 这个 轮胎 的 气压 吗 ？ 
who are you vo@@ ting for ? 	你 投给 谁 ？ 
he will play baseball tomorrow . 	他 明天 将打 棒球 。 
i hur@@ ried in order to catch the first train . 	我 匆匆忙忙 ， 为的是 能 赶上 第一 班 火车 。 
do you plan to eat all of that yourself ? 	你 打算 自己 一人 把 它 全部 吃 了 吗 ？ 
did you miss me ? 	你 想 我 了 ？ 
i have a high opinion of this book . 	我 对 这本书 评 儥 很 高 。 
what do you suppose this could be ? 	你 认为 这是 什么 ？ 
let 's go out and have some fun tonight . 	我们 今晚 一起 出去 找 乐子 吧 。 
it is really cheap . 	它 真的 很 便宜 。 
that novel is n't for children . 	那本 小 说 不 适合 儿童 。 
i do not for a moment think you are wrong . 	我 从没 认为 你 错 了 。 
he is no fool . 	他 不是 傻子 。 
so , what 'll you give me ? 	那 你 会 给 我 什么 ？ 
we know so little about you . 	我们 对 你 知道 得 不 多 。 
nobody supp@@ or@@ ted her . 	没人 支持 她 。 
do n't make stupid jokes . 	开 什么 国际 玩笑 。 
i 'll give you a book . 	我会给 你 一本 书 。 
he is making prepar@@ ations for a trip . 	他 正在 筹备 一次 旅行 。 
she whispered something into his ear . 	她 在 他 耳边 低声 说 话 。 
tom put down his pencil . 	汤姆 放下 他 的 铅笔 。 
when are you going home ? 	你 什么 时候 要 回家 ? 
i go to bed very early . 	我 很 早就 去 睡觉 。 
who 's your most interesting friend ? 	你 最 有趣 的 朋友 是 谁 ？ 
i do n't need anyone . 	我 谁 也 不 需要 。 
i can play chop@@ in . 	我会弹 萧邦 。 
he rep@@ lied that he did not know . 	他 回答 说 他 不 知道 。 
she went into her room to change her dress . 	她 进 了 她 的 房间 换 裙子 。 
she was in a hurry to see her father . 	她 急于 见 她 的 父亲 。 
i think he 's a great writer . 	我 认为 他 是 位 伟大 的 作家 。 
everybody desi@@ res happiness . 	每个 人 都 向往 幸福 。 
i 'm not a beg@@ gar . 	我 不是 乞丐 。 
i 'm going to go sit down . 	我要 坐下 。 
that 's a shame . 	那 是 一个 耻辱 。 
the blanket is still wet . 	这个 毯子 还是 湿 的 。 
we have a special connection . 	我们 有 特殊 联 系 。 
this is a picture of my mother . 	这张 是 我 妈妈 的 照片 。 
i still have n't found anything . 	我 还 什么 都 没 找到 呢 。 
please wash my back . 	请 帮 我 洗 背 。 
i think someone 's knocking on the door . 	我 想 有人 在 敲门 。 
i was born in 19@@ 88 . 	我 生于 1988 年 。 
he put his hands in his po@@ ckets . 	他 把手 插进 口袋 里 。 
he drank very little of the water . 	他 喝 很少 的 水 。 
take your time . 	你 可以 慢慢来 。 
do you often travel abroad ? 	你 经常 去 国外 旅行 吗 ？ 
my mother never gets up early . 	我 的 母亲 从 不 早起 。 
could you do me a favor ? 	请 你 帮 我 一个 忙 好 吗 ？ 
let 's sing the song in english . 	让 我们 唱 英文 歌曲 。 
he has decided to become a teacher . 	他 已经 决定 要 成为 一名 教师 。 
i have to take medicine . 	我 必须 吃药 。 
my pre@@ mon@@ i@@ tion turned out to be right . 	我 的 预感 被 证明 是 正确 的 。 
every man has his price . 	每个 人 都 有 个价 。 
give me your opinion , please . 	请给 我 你 的 意见 。 
i will stay until tomorrow . 	我会 待 到 明天 。 
i 'll stay with tom until you get back . 	你 回来 之前 我会 跟 汤姆 在 一起 。 
the j@@ et lan@@ ded at tokyo . 	这架 客机 降落 在 东京 了 。 
she knows your mother very well . 	她 对 你 的 母亲 很 熟悉 。 
i like eg@@ g@@ plan@@ t . 	我 喜欢 茄子 。 
if you hurry you can still make the train . 	如果 你 抓紧 ， 你 还 能 赶上 火车 。 
you were at my wedding . 	你 出席 了 我 的 婚礼 。 
i 'd like to ask you a few more questions . 	我想 问再 你 几个 问题 。 
i have a friend whose father is a famous writer . 	我 有 个 朋友 的 父亲 是 知名 的 作家 。 
please come back home . 	请 回家 。 
jazz fu@@ sion is a com@@ b@@ ination of rock and jazz . 	融合 爵士 是 摇滚乐 与 爵士 乐 的 融合 。 
she pretended to be a student . 	她 假装 是 学生 。 
i met a friend at the airport . 	我 在 机场 见 了 个 朋友 。 
my brother can drive a car . 	我 哥哥 会 开车 。 
i arrived two weeks ago . 	我 在 两 周前 到 了 。 
i 'll never forget going to hawaii with her . 	我 永远 不会 忘记 那次 跟 她 一起 去 夏威夷 。 
it is rude to laugh at others . 	嘲笑 别人 是 无礼 的 。 
who does this suitcase belong to ? 	这个 手提箱 是 谁 的 ? 
i paid the bill . 	我 买 了 单 。 
everybody is supposed to know the law , but few people really do . 	每 一个 人 都 应该 知法 懂法 ， 但是 真正 能 做到 的 人 却 很少 。 
i do n't know where he comes from . 	我 不 知道 他 从 哪里 来 。 
i do n't know . 	我 一无所知 。 
i have already finished reading this book . 	我 已 经读 完 了 这本书 。 
this summer i went on vacation in scotland . 	这个 夏天 ， 我 去 苏格兰 度假 了 。 
i saw him swim across the river . 	我 看 见 他 游过 了 河 。 
my father will come home at the end of this week . 	我 爸爸 会 在 这 周末 回家 。 
my brother is small but strong . 	我 哥哥 虽然 矮小 可是 很 强壮 。 
is it near your house ? 	它 在 你家 附近 吗 ？ 
he did not appear until about noon . 	直到 快要 中午 前 他 都 没 出现 。 
this is an exception to the rule . 	这是 一个 例外 。 
mary is very cute , is n't she ? 	马力 很 可爱 ， 不是 么 ？ 
i 've got a lot of questions . 	我 有 许多 问题 。 
swimming at night is dangerous . 	夜里 游泳 很 危险 。 
no problem . 	没 问题 。 
the regi@@ stration period is already over . 	报名 时间 已 经过 了 。 
do you want some company ? 	你 想要 伙伴 吗 ？ 
do n't you remember what you said ? 	自己 说 过 的话 都 不 记得 了 吗 ？ 
i do n't have any change . 	我 没 任何 零钱 。 
come on , touch it . 	来 吧 ， 摸 一下 。 
tom does n't know what he should do . 	汤姆 不知所措 。 
japan is famous for mt . fuji . 	日本 以 富士山 闻名 。 
is it cheaper to call after 9@@ :00 ? 	九点 以后打 电话 比 较 便宜 吗 ？ 
i am the fastest run@@ ner . 	我 是 跑 得 最快 的 人 。 
those are their books . 	这是 他们 的 书 。 
this is my book . 	这 是 我 的 书 。 
i hope everything goes well . 	我 希望 万事如意 。 
nobody watches her . 	谁 也 没 在 看 她 。 
you should n't smoke so much . 	你 不该 抽 那么 多烟 。 
do you want to go to the station with me ? 	要 不 一起 到 车站 去 ？ 
i do n't know what tom got . 	我 不 知道 汤姆 拿到 了 甚么 。 
i always feel blue on mondays . 	我 每个 星期一 都 觉得 很 忧郁 。 
she du@@ sts the furniture every day . 	她 每天 擦拭 家具 的 灰尘 。 
i have n't quite finished eating . 	我 还没有 完全 吃 完 。 
i enjoyed talking with him at the party . 	在 派对 中 我 和 他 聊 得 很 开心 。 
where 's my wife ? 	我 的 妻子 在 哪里 ？ 
spring is my favorite season . 	春天 是 我 最 喜欢 的 季节 。 
tom has three cats . 	Tom 有 三 只 猫 。 
we have a party tomorrow evening . 	明天 晚上 我们 有 一个 派 对 。 
it all depends on the weather . 	一切 都 取决 于 天气 。 
i love spending time with tom . 	我 喜欢 花 时间 和 Tom 在 一起 。 
although it is snowing , i must go . 	虽然 正在 下雪 ， 但是 我 也 非 去 不可 。 
i 'm going to the bank . 	我要 去 银行 了 。 
tom ca n't tell mary his real feelings . 	汤姆 不能 把 他 的 真实 感受 告诉 玛丽 。 
he likes to listen to the radio . 	他 喜欢 听 广播 。 
tom is esca@@ ping . 	汤姆 在 逃跑 。 
you should make good use of this opportunity . 	你 要 好好 把握 这个 时机 。 
tom is working hard . 	汤姆 在 努力 工作 。 
i still prefer to write letters by hand . 	我 更 喜欢 用手 写信 。 
i 'll be your first patient . 	我将 是 你 的 第一 个 病人 。 
move the chair n@@ ear@@ er to the desk . 	把 椅子 挪一 挪 靠近 桌子 。 
his quick temper will get him in trouble one day . 	他 的 急 脾气 迟早 会 惹祸 上身 。 
what is your phone number ? 	你 电话号码 是 多少 ？ 
we are sorry we ca n't help you . 	我们 很 遗憾 没能 帮助 你们 。 
you may sit wherever you like . 	你 喜欢 坐 哪儿 就 坐 哪儿 。 
she is a teacher . 	她 是 女 教师 。 
you look sleepy . 	你 看起来 很困 了 。 
we 'll talk about it tomorrow . 	我们 明天 讨论 它 。 
i 'm und@@ re@@ ssing . 	我脱 衣服 。 
the project was a great success . 	该计划 是 一个 大 成功 。 
i got a letter from her today . 	我 今天 收到 了 她 的 信 。 
tom , we have to talk . 	汤姆 ， 我们 必须 谈谈 。 
where are you right now ? 	你现 在 在 哪里 ？ 
how is it going with your family ? 	你 打算 和 你 的 家人 去 做 什么 ？ 
do n't throw ro@@ cks into the river . 	不要 往河里 扔 石头 。 
this book is popular with students . 	这本书 受到 学生 的 欢迎 。 
i would like to speak english fluently . 	我想讲 一口 流利 的 英语 。 
he has no manners at all . 	他 一点 礼貌 也 没 有 。 
tom does n't want to go alone . 	汤姆 不想 一个 人 走 。 
the embassy is located next to the su@@ pre@@ me cou@@ rt . 	大使馆 就 在 最高法院 旁边 。 
what did you do last christmas ? 	去年 圣诞节 做 了 什么 了 ？ 
i got to the station this morning . 	我 今天 上午 到 了 车站 。 
did you bring them ? 	你 把 它们 带来 了 么 ？ 
we ought to obey the law . 	我们 必须 遵纪守法 。 
i do not love him any longer . 	我 已经 不爱 他 了 。 
i like po@@ p music . 	我 喜欢 流行 音乐 。 
could you carry my bags for me ? 	你 可以 帮 我 提 我 的 袋子 吗 ? 
it would appear that you 're wrong . 	你 似乎 错 了 。 
she is far better today than yesterday . 	她 今天 比 昨天 要 好 很多 。 
i was in london last month . 	上个 月 我 在 伦敦 。 
i 'm afraid i ca n't help you . you must ask someone else . 	我 担心 可能 帮不了 你 ， 你 需要 找 其他人 帮忙 。 
she cried her heart out . 	她 哭 得 肝肠寸断 。 
the fire was out . 	火 熄灭 了 。 
tom started singing . 	汤姆 开始 唱歌 。 
can you do some shopping for me ? 	你 能 帮 我 买些 东西 吗 ？ 
prices went up . 	物价 上 涨 。 
we have no idea what to do . 	我们 不 知道 要 做 甚么 。 
would you like a cup of coffee ? 	你 要 来 杯 咖啡 吗 ? 
call me if you dis@@ cover anything . 	如果 你 发现 什么 ， 请 打给 我 。 
i am happi@@ est when i am reading . 	当我 阅读 的 时候 ， 我 最快 乐 。 
when did your father come home ? 	你 爸爸 什么 时候 回家 ？ 
i 've been there a couple of times . 	我 去过 那里 几次 。 
why should it be different ? 	为什么 它 应该 要 变得 不 一样 ？ 
he entered the army . 	他 加入 了 陆 军 。 
would you mind saying that once more ? 	请 你 再 说 一次 好 吗 ？ 
i have already changed my clothes . 	我 已 经换 了 我 的 衣服 。 
you deserve to succeed . 	你 的 成功 是 应得 的 。 
english has spread all over the country . 	英语 已经 普及 全国 。 
how 's it going ? 	你们 好 吗 ？ 
i have no doubts . 	我 没有 疑问 。 
tom is so hot . 	汤姆 非常 性感 。 
it will cost you more to go by plane . 	搭飞机 将花 你 比 较 多 的 钱 。 
take whatever you like . 	你 喜欢 什么 就 拿 吧 。 
i 'm a foreigner . 	我 是 一个 外国人 。 
are you writing a letter ? 	你 在 写 信 吗 ? 
you do n't have to eat . 	你 不必 吃 。 
may i see you in private ? 	我们 能 私下 见 见 吗 ？ 
there is no hope of his reco@@ very . 	他 没 有 希望 痊 愈 了 。 
i do n't want to live my life in fear . 	我 不想 在 恐惧 中 生活 。 
may i have a bus schedule ? 	我 可以 有 张公车 的 时刻表 吗 ？ 
she makes all her own clothes . 	她 的 衣服 全部 都 是 她 自己 做 的 。 
how long have you been working here ? 	从 什么 时候 开始 您 就 这里 工作 着 的 呢 ？ 
when is your bed@@ time ? 	你 什么 时候 睡觉 ？ 
in doing anything , you must do your best . 	做 任何 事 ， 你 必须 要 做到 最好 。 
how horri@@ ble ! 	真 糟糕 ！ 
i know him . 	我 认识 他 。 
please show your ticket . 	请 出示 您 的 票子 。 
my father does n't like soccer . 	我 爸爸 不 喜欢 足球 。 
we have no reason to be ashamed . 	我们 没 理由 害臊 。 
the sky was completely dark . 	天空 完全 变黑 了 。 
he was absent from school yesterday . 	他 昨天 没来 上学 。 
she taught music for thirty years . 	她 教 了 三十年 的 音乐 。 
i felt good tonight . 	我 今晚 感觉 良好 。 
i see you found your bag . 	我见 你 找到 了 你 的 包 。 
we went to the mountains to sk@@ i . 	我们 去 山上 滑雪 。 
i wish i had a better memory . 	但愿 我 有 好 一点 的 记忆力 。 
i go to the country every summer . 	我 每年 夏天 都 去 乡 下 。 
she had a little money . 	她 有 一点 钱 。 
they love each other . 	他们 彼此 相爱 。 
what are you doing down there ? 	你 在 那里 干什么 ？ 
if you do n't hurry , you 'll miss the train . 	如果 你 不 抓紧 的话 ， 你 就 会 赶不上 火车 。 
hurry up , or you will miss the train . 	快点 ， 不然 你 就要 错过 火车 了 。 
he wrote a book about a jun@@ gle ad@@ venture . 	他 写 了 一本 关于 丛林 冒险 的 书 。 
i wrote down that telephone number . 	我 写 下 了 那个 电话 号码 。 
i 'll see you next month . 	我 下个 月 会 来 看 你 。 
take the p@@ an off the fire . 	把 平底 锅离火 。 
i 've never climbed mt . fuji . 	我 从 来 没 有 爬过 富士山 。 
no matter what i do , she says i can do better . 	不论 我 做 什么 ， 她 都 说 我 能 做 得 更好 。 
it looks like the dog wants something to eat . 	那 只 狗 看 起来 好像 想 吃 东西 。 
tom is leaving boston tomorrow . 	汤姆 明天 离开 波士顿 。 
it is wrong to tell a lie . 	说谎 是 错误 的 。 
i desp@@ ise you . 	我 鄙视 你 。 
tom does n't talk much . 	汤姆 说话 不多 。 
how can i reach you ? 	我 怎样 才能 连络 到 你 ? 
the war has not ended . 	战争 还 没 结束 。 
how much money do you have hi@@ d@@ den under your bed ? 	你 在 你 的 床 下面 藏 了 多少 钱 ？ 
that mountain is covered with snow . 	这座 山 被 雪 所 覆盖 。 
it has been three months since he left japan . 	自从 他 离开 日本 已经 有 三个 月 了 。 
do you think i 'm joking ? 	你 觉得 我 是 在 开玩笑 吗 ？ 
eat a lot of vegetables . 	多吃点 蔬菜 。 
is n't this weather just great ! 	天气 真是 太好 了 ！ 
he is the chief of my department . 	他 是 我 部门 的 主管 。 
everyone wants to meet you . you 're famous ! 	大家 都 想 见到 你 ， 你 太 有名 了 ！ 
she plays the violin very well . 	她 小提琴 演奏 得 非常 好 。 
you may go home now . 	你现 在 可以 回家 了 。 
he was jealous of my success . 	他 嫉妒 我 的 成功 。 
read lesson 10 from the beginning . 	从 第十 课 的 开头 读起 。 
it 's the only thing i can think of . 	这 是 我 唯一 能 想到 的 事 了 。 
i never thought it would come to this . 	我 从没 想过 它 会 变成 这样 。 
where is the problem ? 	哪里 有 问题 ? 
can i speak to the head nurse ? 	我能 跟 护士长 说 话 吗 ? 
i borrow money . 	我 借 钱 。 
tickets are available now . 	现在 有票 。 
the poor girl went blind . 	这可怜 的 女孩 瞎 了 。 
she goes to a@@ er@@ o@@ bi@@ cs once a week . 	她 每 星期 去作 一次 健美操 。 
what do you usually do in your spare time ? 	你 在 闲暇 的 时候 一般 做什么 ？ 
i 'll come back . 	我会 回来 的 。 
could you put this report into italian for me ? 	你 可以 为 我 把 这份 报告 翻译成 意大利文 吗 ？ 
i 've just started playing tennis . 	我刚 开始 打 网球 。 
he has a large family . 	他 有 一个 大家庭 。 
he knows how to cap@@ ti@@ va@@ te his audience . 	他 知道 如何 去 吸引 他 的 听众 。 
she is only a child . 	她 只是 个 孩子 。 
i do n't think tom is serious . 	我 不觉 得 汤姆 是 认 真的 。 
he 's bound to forget . 	他 准会 忘 。 
he has had a c@@ rush on her . 	他 一直 暗恋 着 她 。 
she was wearing dark brown shoes . 	她 穿 著 深褐色 的 鞋子 。 
i 'm going to the park . 	我 去 公园 。 
he traveled all over the world . 	他 周游 世界各地 。 
it 's supper time . 	吃 晚饭 的 时间 到 了 。 
english is an international language . 	英语 是 国际 语言 。 
my mother plays the piano well . 	我 的 母亲 钢琴弹 得 很 好 。 
she always takes care of her children . 	她 毫无间 断 地 照顾 自己 的 孩子 。 
what do you plan to sell ? 	你 计划 卖 甚么 ？ 
read this now . 	现在 读 这个 。 
it 's a waste of time and money . 	这 是 在 浪费 时间 和 金钱 。 
i ca n't say for sure . 	我 不 太 确定 。 
could you send it to this address ? 	你 能 把 它 送到 这个 地址 吗 ？ 
i 'm looking forward to your visit . 	我 期待 著 您 的 光临 。 
tom finally did something right . 	汤姆 最终 做 了 点 正确 的 事 。 
has something happened ? 	发生 了 什么 事 吗 ？ 
will it take long to recover ? 	要 很长 的 时间 才能 恢 复 吗 ？ 
i bought a camera the other day . 	我前 几天 买 了 一台 照相 机 。 
i 'm sorry i did n't reply to you sooner . 	抱歉 ， 我 没 有 早点 回复 你 。 
it is easy to answer this question . 	回答 这个 问题 很 容易 。 
are you going to sing here ? 	你们 要 在 这里 唱歌 吗 ？ 
someone told me about that . 	有人 跟 我 说 这件 事 。 
he wei@@ gh@@ s a lot more than before . 	他 比 以前 重得 多 。 
the room is fully furnished . 	房间里 家具 齐全 。 
how do you want your hair cut ? 	你 想 将头 发 剪成 怎样 ？ 
do you have a cough ? 	你 咳嗽 吗 ？ 
i did n't trust tom and he did n't trust me , either . 	我 不 信任 汤姆 而且 汤姆 也 不 信任 我 。 
i 've heard the french ver@@ sion of this song . 	我 听 过 这 首歌 的 法语 版 。 
that was three days ago . 	这是 三天 之前 了 。 
the children are having fun in the park . 	孩子 们 在 公园 里 玩耍 。 
jealousy made him do that . 	嫉妒 让 他 那样 做 。 
has the bell rung ? 	钟响 过 了 吗 ？ 
i smell gas . 	我闻 到 瓦斯 味 。 
i think i 'll go by bus . 	我 认为 我 要 坐 巴士 去 。 
let 's take a walk in the park . 	让 我们 在 公园里 散步 吧 。 
you look ten@@ se . 	你 看起来 很 紧张 。 
what time will you have breakfast ? 	你 什么 时候 吃 早餐 ？ 
something is wrong with my watch . 	我 的 表 出 了 毛病 。 
there 's only a little milk left . 	只 剩下 一点点 牛奶 了 。 
he had kept the secret to himself . 	他 保守 著 这个 秘密 。 
come on over to have a try . 	你 过来 试试 看 。 
she has att@@ ra@@ ctive eyes . 	她 有 一双 迷人 的 眼睛 。 
i get you . 	我 了解 你 。 
children should obey their parents . 	孩子 应该 服 从 他们 的 父母 。 
i did nothing out of the ordinary . 	我 没 做 不 寻常 的 事 。 
ho@@ p in . 	跳 进来 。 
do i have to do it right away ? 	我 必须 立刻 做 吗 ？ 
she may be late , in which case we will wait . 	她 可能 迟到 ， 然后 我们 就要 等 。 
is this fish still alive ? 	这条 鱼 还是 活 的 吗 ？ 
i 'm not le@@ tting tom do this by himself . 	我 不会 让 汤姆 独自 去 做 。 
this box is too bul@@ k@@ y to carry . 	这个 箱子 太 笨重 了 无法 携带 。 
he had a large family to support . 	他 要 养活 一个 大家庭 。 
it 's a surprise . 	这是 一个 惊喜 。 
he threw a ball over the fence . 	他 把 球 扔过 了 栅栏 。 
i should have taken the money . 	我应 该 拿 那些 钱 的 。 
the school was est@@ ab@@ li@@ shed in 16@@ 50 . 	这所 学校 建于 1650 年 。 
he has no reason to be late . 	他 迟到 没有 理由 。 
she managed to drive a car . 	她 成功 地开车 了 。 
did n't you lock up your car ? 	你 没有 把 你 的 车上 锁 吗 ？ 
i had a lot of fun . 	我 玩 得 很 开心 。 
i 'm a stranger here myself . i 'm afraid i ca n't help you . 	我 对 这里 不熟 。 恐怕 我 不能 帮 你 。 
is eating with chop@@ sti@@ cks difficult ? 	用 筷子 吃 饭 难 吗 ？ 
keep on smiling . 	保持 微笑 。 
tom was caught driving without a license . 	Tom 被 抓 到 无照 驾驶 。 
he was n't the same as i thought he 'd be . 	他 跟 我 想 的 不 一样 。 
the law should not be vio@@ lated . 	法律 不应 受到 侵犯 。 
we had a good time last night . 	我们 昨晚 玩得 很 开心 。 
i do n't want to fail my exams . 	我 不想 不 通过 考试 。 
i had to change clothes because what i was wearing was n't appro@@ priate for the situation . 	我 必须 要换 衣服 ， 因为 我 现在 穿 的 衣服 不 适合 这个 环境 。 
really ? 	你 确定 ？ 
the potato was so hot that it burned my mouth . 	土豆 太热 ， 以至于 烫 到 了 我 的 嘴 。 
we are looking forward to seeing you and your family . 	我们 很 期待 见到 您 和 您 的 家人 。 
i ca n't answer you now . 	我 现在 不能 回答 你 。 
she is good at playing tennis . 	她 擅长 打 网球 。 
this is a hospital . 	这是 医院 。 
we 'll come back tomorrow . 	我们 明天 回来 。 
we 'll begin tomorrow morning . 	我们 明天 上午 开始 。 
would you like some scra@@ mb@@ led egg ? 	你 想要 来些 炒 蛋 吗 ？ 
i came to war@@ n you not to do that . 	我来 警告 你别 那样 做 。 
it is warmer today than yesterday . 	今天 比 昨天 暖和 。 
tom came a little earlier today than he usually does . 	汤姆 今天 来得 比 往常 要 早 一些 。 
it 's really hot here in the summer . 	这里 夏天 非常 热 。 
i a@@ woke to find it snowing . 	当我醒 来 时 ， 天正 下著雪 。 
spring is the best season to visit kyoto . 	春天 是 访问 京都 最好 的 季节 。 
will you please show me the way ? 	请 你 告诉 我路 怎么 走 好 吗 ？ 
i 'm on my way . 	我 这 就 上路 。 
my father is healthy . 	父亲 很 健康 。 
i have some good news for you . 	我 有 好消息 要 告诉 你 。 
tom did n't give me what i asked him for . 	汤姆 没 给 我 我 跟 他 要 的 。 
there 's not a cloud in the sky . 	天上 没有 云 。 
who picked you for this mission ? 	谁 选 你 来 做 这个 任务 ？ 
i left my umbrella in the cab . 	我 把 我 的 伞忘 在 计程车 上 了 。 
all of a sudden , three dogs appeared in front of us . 	突然 之间 ， 三 只 狗 出现 在 我们 面前 。 
i 'd better do it right now . 	我 马上 做 比较 好 。 
did you enjoy yourself yesterday ? 	你 昨天 玩得 开心 吗 ? 
that 's a book . 	那 是 一本 书 。 
i need to know tomorrow . 	我 明天 需要 知道 。 
i do n't blame you for doing that . 	我 不怪 你 那样 做 。 
this is a dangerous mission . 	这是 个 危险 的 任务 。 
i have n't seen you for a while . 	我 好 一阵子 没 看到 你 了 。 
the school needed a new teacher . 	学校 需要 一个 新 的 老师 。 
you can come at any time . 	你 随时 可以 来 。 
let 's see what 's in the box . 	看看 我会 在 盒子 里 找到 什么 ? 
finally , he reached his goal . 	他 终于 达到 了 自己 的 目标 。 
tom is the tallest man i know . 	汤姆 是 我 所 知道 的 最高 的 人 。 
it is very hot here in the summer . 	这里 夏天 非常 炎热 。 
i ate tom 's sandwich . 	我 吃 了 汤姆 的 三明治 。 
i 'll show you the way . 	我会 为 你 带路 。 
i wish tom could 've been there . 	我 希望 汤姆 能 在 那里 。 
he is playing music . 	他 在 演奏 音乐 。 
a barber is a man who sha@@ ves and cu@@ ts men 's hair . 	理 发 师是 为 男人 刮 胡 子 和 剪 头 发 的 人 。 
after supper , i washed the dishes . 	晚饭 后 我 洗 了 碗碟 。 
tom went to boston to buy a painting . 	汤姆去 波士顿 买 一幅 画 。 
move quietly . 	轻轻地 移动 。 
i took the children to school . 	我带 孩子 们 去 上学 。 
she 's busy now and ca n't speak to you . 	她现 在 忙 ， 没有 办法 跟 你 们 说 话 。 
many asi@@ ans have english as a common language . 	许多亚洲 人以 英语 作为 共用 的 语言 。 
i like to eat . 	我 喜欢 吃 。 
it is too expensive . 	这 太贵 了 。 
i like bea@@ ns . 	我 喜欢 豆子 。 
there used to be a lot of fro@@ gs in this pond . 	以前 在 这个 池塘 里有 许多 青蛙 。 
are you busy ? 	你 忙 吗 ？ 
fini@@ shing the report by tomorrow is next to impossible . 	在 明天 前 完成 报告 几乎 是 不 可能 的 。 
if you do n't understand , ask . 	如果 你 不 懂 ， 那 就 问 。 
he is good at playing tennis . 	他 打 网球 打得 很 好 。 
i 'll stop by your place on my way home . 	我 回家 路上 会 在 你 那里 停下 。 
he played baseball after school . 	他 放学 后 打 棒球 。 
i had a feeling this might happen . 	我 早 有 一种 感觉 这 可能 会 发生 。 
can you wake me up at 7:00 tomorrow ? 	你 明天 早上 七点 可不可以 叫 我 起床 。 
the soldier gave water to me . 	士兵 给了 我 水 。 
he came here ten minutes ago . 	他 十分 钟前 到 这里 。 
you can go to the b@@ all@@ park on this bus . 	坐 这个 公车 可以 到 球场 。 
i owe it you that i am still alive . 	多亏 了 你 ， 我 还 活着 。 
a@@ i stands for artificial intelligence . 	AI 代表 人工智能 。 
she is n't a good cook . 	她 不是 一个 好 厨师 。 
you do n't have to eat it . 	你 不必 吃 。 
